lang_pair,src_num_texts,src_num_tokens,src_num_segments,tgt_num_texts,tgt_num_tokens,tgt_num_segments,tot_num_tokens
eng_Latn-fra_Latn,932393965,13115000000,1857152334,932393965,17774000000,808169798,30889000000
eng_Latn-spa_Latn,759721472,13140000000,1487188402,759721472,14329000000,667176107,27469000000
eng_Latn-deu_Latn,560988113,8546759248,1067582424,560988113,8091456245,486725072,16638215493
eng_Latn-ita_Latn,295179477,4964965008,580356057,295179477,5039916861,257074288,10004881869
spa_Latn-fra_Latn,285929091,4259401362,228186058,285929091,4325941443,222140770,8585342805
deu_Latn-eng_Latn,247466857,3750995010,223910461,247466857,3898775458,484768918,7649770468
deu_Latn-fra_Latn,231945903,3557585311,212160094,231945903,4084773161,197924691,7642358472
eng_Latn-nld_Latn,249200292,3541556701,485106821,249200292,3566042505,211165767,7107599206
deu_Latn-spa_Latn,206183312,3104820067,184069108,206183312,3529599704,176700641,6634419771
spa_Latn-por_Latn,198464184,3383741948,166675885,198464184,3226060076,164390031,6609802024
eng_Latn-rus_Cyrl,208960371,3509910361,421679683,208960371,3070524576,192274297,6580434937
eng_Latn-por_Latn,173741843,3182795789,347190324,173741843,3298085702,158294915,6480881491
deu_Latn-ita_Latn,141320368,2236879989,131225286,141320368,2411416073,123998472,4648296062
spa_Latn-ita_Latn,148211595,2381518912,120444900,148211595,2251919714,117498071,4633438626
fra_Latn-ita_Latn,147718670,2278901783,114548499,147718670,2128767036,114681351,4407668819
eng_Latn-pol_Latn,165833150,2288004578,331230871,165833150,2002109228,148168045,4290113806
eng_Latn-swe_Latn,160858530,2198925471,307811233,160858530,2038121699,128121785,4237047170
deu_Latn-por_Latn,127310706,1812633704,117716405,127310706,1965449448,115013782,3778083152
deu_Latn-nld_Latn,129199714,1828455888,117188393,129199714,1938836600,112624676,3767292488
fra_Latn-por_Latn,127813555,1917708591,99664352,127813555,1803140357,101487605,3720848948
eng_Latn-ces_Latn,156176838,1970863729,299214105,156176838,1732588277,127542249,3703452006
eng_Latn-ron_Latn,134655967,1825811255,269029268,134655967,1873832915,118329415,3699644170
eng_Latn-ara_Arab,109718201,1879242506,228621001,109718201,1669274119,82298311,3548516625
eng_Latn-dan_Latn,117108665,1700290815,227974719,117108665,1620056449,104010017,3320347264
eng_Latn-ell_Grek,119189268,1639456131,238267982,119189268,1631862212,105861125,3271318343
eng_Latn-hun_Latn,123801160,1519484405,238503300,123801160,1289014137,100810303,2808498542
ara_Arab-fra_Latn,74875238,1200991426,55212411,74875238,1565291875,70750904,2766283301
eng_Latn-ind_Latn,95102192,1409184248,185082318,95102192,1291585115,80742635,2700769363
ara_Arab-spa_Latn,88653018,1187414523,60649191,88653018,1483599958,83269881,2671014481
eng_Latn-bul_Cyrl,102896824,1329555793,208770092,102896824,1253807596,90826875,2583363389
cat_Latn-spa_Latn,65367607,1194136975,56075135,65367607,1217634142,56600528,2411771117
eng_Latn-fin_Latn,107437886,1389119324,209090725,107437886,1013276704,87004385,2402396028
eng_Latn-sqi_Latn,93894245,1138201483,189461974,93894245,1192092346,77642036,2330293829
eng_Latn-vie_Latn,66887222,972937278,130209562,66887222,1324999188,54061871,2297936466
deu_Latn-swe_Latn,77799172,1073792036,68479680,77799172,1035752600,65235135,2109544636
eng_Latn-slk_Latn,80472049,1070546850,149499638,80472049,953706345,63366179,2024253195
eng_Latn-tur_Latn,99667166,1106583758,202678684,99667166,866663350,86725563,1973247108
deu_Latn-pol_Latn,82447581,1008736278,71528974,82447581,933026285,70983462,1941762563
bos_Latn-eng_Latn,79328030,893260323,71207926,79328030,1004613308,159704023,1897873631
eng_Latn-epo_Latn,75828450,953892821,151998827,75828450,904247527,64322395,1858140348
deu_Latn-rus_Cyrl,71896193,945829380,63808818,71896193,868523529,61991969,1814352909
zho_Hani-eng_Latn,99232947,119128552,174658509,99232947,1677111852,202784111,1796240404
ara_Arab-rus_Cyrl,55203656,888275879,39768103,55203656,898335830,54743246,1786611709
spa_Latn-rus_Cyrl,55940893,974275298,48750142,55940893,782909360,48719712,1757184658
dan_Latn-deu_Latn,60609063,867203855,56013070,60609063,872356505,55499156,1739560360
ara_Arab-eng_Latn,49696666,805819840,43269747,49696666,900915226,98906593,1706735066
spa_Latn-nld_Latn,48597918,851007041,42429124,48597918,804800589,42002910,1655807630
ces_Latn-deu_Latn,66505607,783722761,58504830,66505607,858320833,59122222,1642043594
ell_Grek-eng_Latn,49261684,833213907,44395370,49261684,802625997,97030379,1635839904
glg_Latn-por_Latn,89216914,733011999,40060453,89216914,899559386,46990330,1632571385
eng_Latn-nor_Latn,65190731,809584326,127517130,65190731,770148703,53323596,1579733029
eng_Latn-msa_Latn,74490701,822167238,152406825,74490701,741611171,68536863,1563778409
fra_Latn-ron_Latn,58564050,803915739,45371776,58564050,753811853,45724606,1557727592
deu_Latn-ell_Grek,55080626,757945619,50967923,55080626,794569891,49174758,1552515510
spa_Latn-ron_Latn,57053577,786183583,45536176,57053577,750996219,44749338,1537179802
eng_Latn-slv_Latn,62767705,807379229,124653476,62767705,710550472,53435906,1517929701
ces_Latn-eng_Latn,56306306,702317529,48278731,56306306,810988062,109650669,1513305591
aze_Latn-eng_Latn,74488598,617018922,64367953,74488598,848931522,152964267,1465950444
dan_Latn-eng_Latn,52273004,703392127,45167063,52273004,726944226,101350756,1430336353
fra_Latn-rus_Cyrl,48314160,791616721,39840387,48314160,627752812,40950944,1419369533
fra_Latn-nld_Latn,38142273,714578466,33171884,38142273,667117072,33691097,1381695538
eng_Latn-fil_Latn,63621424,657689068,132108854,63621424,696237703,58268387,1353926771
bul_Cyrl-eng_Latn,44634569,661395059,39484634,44634569,684764097,87337393,1346159156
eng_Latn-hin_Deva,56762219,643253351,109677464,56762219,678088371,13348261,1321341722
deu_Latn-ron_Latn,49682107,635789669,45516432,49682107,685026740,44688482,1320816409
eng_Latn-lit_Latn,48903352,707429820,90973956,48903352,580839580,42203617,1288269400
eng_Latn-hrv_Latn,61144377,687612416,125852583,61144377,599968006,54943054,1287580422
eng_Latn-ukr_Cyrl,44071340,675445601,83759984,44071340,580842665,36346866,1256288266
deu_Latn-hun_Latn,51647990,665397287,46707645,51647990,590226240,46062083,1255623527
ara_Arab-por_Latn,66029388,581446134,36816172,66029388,663200036,62863333,1244646170
eng_Latn-fas_Arab,44158688,577456051,88558255,44158688,636941912,32850586,1214397963
eng_Latn-est_Latn,50923118,682931317,99974392,50923118,527875256,43653383,1210806573
eng_Latn-lav_Latn,41673145,622748478,77194917,41673145,578232534,41632948,1200981012
eng_Latn-srp_Latn,63966564,637963246,136602836,63966564,559111368,58229282,1197074614
eng_Latn-zho_Hani,69060021,1071457119,136819307,69060021,105153857,126298957,1176610976
ell_Grek-spa_Latn,45196493,575814492,36039505,45196493,599967446,36200910,1175781938
zho_Hani-fra_Latn,51600461,59736421,86418470,51600461,1111540941,46667499,1171277362
deu_Latn-fin_Latn,48836320,657379529,45668130,48836320,498821241,42918405,1156200770
ell_Grek-fra_Latn,44350404,546233700,35330803,44350404,580448726,34607136,1126682426
deu_Latn-slk_Latn,41485359,586031003,36556569,41485359,540279171,36084203,1126310174
zho_Hani-spa_Latn,53191206,61190521,88613189,53191206,1049744167,50714248,1110934688
bul_Cyrl-deu_Latn,43419800,546465070,38655378,43419800,547013044,40052845,1093478114
deu_Latn-nor_Latn,43631775,546176156,35831309,43631775,533211176,34541466,1079387332
fra_Latn-swe_Latn,36627081,583256414,29481595,36627081,494738392,29966493,1077994806
ces_Latn-slk_Latn,37409727,520063735,33595513,37409727,522853013,33425565,1042916748
ben_Beng-eng_Latn,62004576,503547000,77567927,62004576,535232217,121911911,1038779217
eng_Latn-heb_Hebr,55181952,574323977,114226717,55181952,460055918,47089945,1034379895
spa_Latn-ind_Latn,39863591,527261664,32800116,39863591,451966576,31925306,979228240
deu_Latn-slv_Latn,36712507,489365964,33394969,36712507,450555730,32013229,939921694
spa_Latn-pol_Latn,38803565,515572710,30441738,38803565,421764696,31122304,937337406
spa_Latn-vie_Latn,33994187,416766341,26969596,33994187,519990393,23445488,936756734
fra_Latn-pol_Latn,39224045,514658035,29890230,39224045,413854670,31438886,928512705
eng_Latn-guj_Gujr,39589950,478919010,79953065,39589950,430689957,34220203,909608967
eng_Latn-tam_Taml,50911786,489477715,102616510,50911786,386447333,46130498,875925048
bel_Cyrl-eng_Latn,44580858,395144167,38988840,44580858,474679550,91301381,869823717
eng_Latn-tel_Telu,47149303,468880051,93791432,47149303,397131149,45594222,866011200
spa_Latn-glg_Latn,32164010,439460179,24647512,32164010,414916532,24345906,854376711
spa_Latn-hun_Latn,37757013,468521831,28726645,37757013,376536968,28954714,845058799
eng_Latn-mal_Mlym,51651074,481687671,104060933,51651074,360243128,49033771,841930799
fra_Latn-hun_Latn,38710845,469457540,28107754,38710845,370160369,29241464,839617909
eng_Latn-urd_Arab,33451188,360811172,66824180,33451188,475732464,12141856,836543636
ara_Arab-deu_Latn,34908385,406787157,24345170,34908385,429637287,32266260,836424444
eng_Latn-cat_Latn,28399960,401405114,54946362,28399960,424095780,24023822,825500894
deu_Latn-tur_Latn,42926487,450304951,36982443,42926487,373938371,36785504,824243322
ara_Arab-ita_Latn,35858862,375126700,22415153,35858862,430762275,35724843,805888975
spa_Latn-swe_Latn,33993805,414978662,26198635,33993805,362754633,25539090,777733295
dan_Latn-spa_Latn,24133360,357820630,21346450,24133360,406723387,20430459,764544017
dan_Latn-fra_Latn,24285409,346199395,21207936,24285409,396849806,19813854,743049201
zho_Hani-rus_Cyrl,40408609,45540223,67967889,40408609,692304121,39171218,737844344
deu_Latn-est_Latn,29420828,407005743,27380130,29420828,326925261,26395177,733931004
fin_Latn-fra_Latn,36261715,296005700,28554867,36261715,432105886,27327852,728111586
afr_Latn-eng_Latn,39313352,358957820,29633863,39313352,367199654,78426926,726157474
eng_Latn-kor_Hang,34532241,394243258,64922911,34532241,321336479,24428734,715579737
deu_Latn-lit_Latn,25028916,383296251,22692018,25028916,326134669,23311598,709430920
spa_Latn-fin_Latn,34145602,411705498,26886443,34145602,287113354,27149505,698818852
eng_Latn-ltz_Latn,22829276,281567510,45406022,22829276,410151089,9715140,691718599
ces_Latn-spa_Latn,29895346,309924019,23816557,29895346,381317123,23439504,691241142
ces_Latn-fra_Latn,30624059,306424956,24554849,30624059,383927128,23416373,690352084
dan_Latn-swe_Latn,23104010,340471534,20479610,23104010,331022725,19647182,671494259
eng_Latn-kaz_Cyrl,35372289,379840023,70703057,35372289,286061885,29729515,665901908
deu_Latn-lav_Latn,21597239,341598738,19566561,21597239,323810195,24287219,665408933
spa_Latn-slk_Latn,22508467,368924431,18387400,22508467,296217204,18721536,665141635
eng_Latn-swa_Latn,31372355,343751829,61515513,31372355,314435300,24493655,658187129
fra_Latn-slk_Latn,22700942,365736877,17946698,22700942,290141486,18719502,655878363
eng_Latn-kan_Knda,34585785,362708880,68893248,34585785,288900331,31326905,651609211
deu_Latn-ind_Latn,27485644,333197126,22864415,27485644,317991743,22527191,651188869
eng_Latn-nob_Latn,19595653,329147091,37137302,19595653,313533305,16544763,642680396
ara_Arab-nld_Latn,32133030,300894710,18775532,32133030,337560144,31676167,638454854
ell_Grek-por_Latn,23324536,318329571,19091827,23324536,317757290,19174999,636086861
bul_Cyrl-rus_Cyrl,28131231,335618137,23820685,28131231,299872328,23166645,635490465
ces_Latn-pol_Latn,31782945,312057598,25265276,31782945,314800431,25290696,626858029
eng_Latn-gle_Latn,26821145,287045350,51378311,26821145,331676724,18603127,618722074
eng_Latn-mlt_Latn,20523766,333211482,39466147,20523766,279577029,16594870,612788511
cat_Latn-eng_Latn,21284153,312337406,17753908,21284153,296470859,41284455,608808265
eng_Latn-srp_Cyrl,26510560,319522151,51669454,26510560,288878621,21525232,608400772
eng_Latn-uzb_Latn,30969709,350324035,63508404,30969709,253836946,25342446,604160981
ara_Arab-pol_Latn,34071388,306954719,19326874,34071388,293382160,32082007,600336879
eng_Latn-mar_Deva,35908910,309465328,70218166,35908910,289945360,29850185,599410688
spa_Latn-nor_Latn,20612635,317506062,17341084,20612635,281290107,17262365,598796169
zho_Hani-ara_Arab,32639886,35669932,52633932,32639886,558393331,23384935,594063263
eng_Latn-sin_Sinh,31995687,296055006,67327346,31995687,287320965,32510461,583375971
fra_Latn-nor_Latn,20658760,311864774,16679069,20658760,271018284,17042665,582883058
deu_Latn-hrv_Latn,28049050,301613133,25171024,28049050,275137484,25157404,576750617
ces_Latn-por_Latn,25644681,263496057,20436438,25644681,310419912,20031292,573915969
ell_Grek-ita_Latn,15994891,287511250,14289490,15994891,283498318,13843107,571009568
deu_Latn-vie_Latn,19111830,236373025,15976611,19111830,330522599,14828235,566895624
fra_Latn-vie_Latn,16039046,253129456,13133987,16039046,312666969,12574732,565796425
ara_Arab-tur_Latn,34757258,291490153,18537937,34757258,259985267,32630278,551475420
ces_Latn-nld_Latn,25525053,246015483,20469463,25525053,287262735,19780730,533278218
ara_Arab-ron_Latn,30623567,243223283,15687985,30623567,283959056,30171026,527182339
cat_Latn-fra_Latn,24385716,258630044,18155528,24385716,267161401,17747641,525791445
fra_Latn-lit_Latn,24571479,300330520,18439510,24571479,222613299,20108065,522943819
spa_Latn-lit_Latn,23713057,293138306,18414530,23713057,221256271,19587444,514394577
dan_Latn-nld_Latn,16561876,246067508,14943446,16561876,264645296,14188471,510712804
dan_Latn-nor_Latn,17682797,249620155,15491053,17682797,246743147,15167038,496363302
fin_Latn-swe_Latn,18143082,214942693,16390305,18143082,276295883,16416120,491238576
dan_Latn-ita_Latn,14651821,234390855,13362661,14651821,253242662,12484859,487633517
spa_Latn-slv_Latn,16329409,266369647,13202853,16329409,217241091,13291608,483610738
fra_Latn-slv_Latn,16574357,267269327,12916043,16574357,215420041,13337229,482689368
aze_Latn-rus_Cyrl,22725014,221246106,20562954,22725014,254375455,22050647,475621561
ara_Arab-ces_Latn,29326768,238140806,15384897,29326768,237131695,28359706,475272501
bul_Cyrl-ita_Latn,14013265,230358522,12398153,14013265,242810398,11870473,473168920
deu_Latn-srp_Latn,26060685,247986363,23814439,26060685,224821434,23585500,472807797
cym_Latn-eng_Latn,18902275,238183627,14573359,18902275,233184136,37314435,471367763
dan_Latn-por_Latn,14016436,223128271,12854188,14016436,243171028,12427303,466299299
ces_Latn-rus_Cyrl,25174719,231135065,19973568,25174719,232726089,19671443,463861154
bel_Cyrl-rus_Cyrl,19474227,230491030,18468073,19474227,233235314,19281372,463726344
fra_Latn-ind_Latn,20024194,245409171,15770359,20024194,204422742,15654915,449831913
spa_Latn-fas_Arab,19189893,216116903,15634920,19189893,223092313,13548029,439209216
ces_Latn-swe_Latn,22564823,213199931,17704372,22564823,225969798,17076139,439169729
fra_Latn-glg_Latn,23724163,230788698,19623350,23724163,203411867,18985392,434200565
ara_Arab-ell_Grek,25826720,203948124,13095295,25826720,227145297,26042312,431093421
ara_Arab-hun_Latn,28097341,217934165,14349009,28097341,208104260,26020881,426038425
bul_Cyrl-pol_Latn,19468888,223925859,15801662,19468888,201959151,15954224,425885010
eng_Latn-mkd_Cyrl,17409098,215499116,34498418,17409098,209946626,14490382,425445742
hun_Latn-ita_Latn,13499714,193213681,12017751,13499714,232055811,11339377,425269492
ara_Arab-ind_Latn,20502829,209038531,13509704,20502829,212785469,17513063,421824000
eng_Latn-kir_Cyrl,21599810,251374890,43907621,21599810,168343055,17707685,419717945
spa_Latn-zho_Hani,23454354,381782456,20245923,23454354,37634064,41765790,419416520
spa_Latn-tur_Latn,22791118,232577293,16956991,22791118,176363244,16925130,408940537
ara_Arab-vie_Latn,15476543,163839523,10685029,15476543,240323036,11673796,404162559
fra_Latn-tur_Latn,22610897,229237198,16382487,22610897,168109642,16974776,397346840
ara_Arab-swe_Latn,20120235,193690325,12398258,20120235,201863176,18617169,395553501
fra_Latn-heb_Hebr,23175837,223805430,16752019,23175837,168209040,16003922,392014470
spa_Latn-heb_Hebr,22027386,218820781,16676433,22027386,170305270,15283722,389126051
eng_Latn-nep_Deva,21197431,193890668,42153212,21197431,193940997,3646205,387831665
deu_Latn-heb_Hebr,22311568,206825300,20242021,22311568,172142014,19721597,378967314
ara_Arab-bul_Cyrl,25729765,182336440,12474228,25729765,192460184,24326988,374796624
ell_Grek-nld_Latn,10996346,186320324,9692820,10996346,185087272,9492768,371407596
bul_Cyrl-ron_Latn,10469353,175276410,9406077,10469353,187373487,9315431,362649897
ara_Arab-heb_Hebr,24148104,183182180,11961519,24148104,174524760,23237369,357706940
epo_Latn-fra_Latn,17437641,164639326,14354235,17437641,188372096,15163837,353011422
ell_Grek-rus_Cyrl,12810743,191284779,11089560,12810743,160431875,11028052,351716654
zho_Hani-por_Latn,28762530,32220133,42292942,28762530,318217807,26886743,350437940
fra_Latn-zho_Hani,20922292,314852262,16707905,20922292,34572467,36442959,349424729
ara_Arab-srp_Latn,23232492,171081819,11542366,23232492,175512943,22986830,346594762
ell_Grek-ron_Latn,9619459,172857995,8690195,9619459,173205957,8677545,346063952
eng_Latn-mon_Cyrl,17100127,195038304,35376882,17100127,150833478,14798426,345871782
eng_Latn-hye_Armn,16303325,189770937,33419120,16303325,146233269,5966277,336004206
bul_Cyrl-nld_Latn,10493537,162812250,9194037,10493537,171806630,8927965,334618880
eng_Latn-jav_Latn,18775173,178181841,40235815,18775173,156268499,18561242,334450340
eng_Latn-hat_Latn,15656544,163197062,30800906,15656544,171006495,11770777,334203557
bul_Cyrl-ces_Latn,11141955,176130968,9754910,11141955,155352567,9688641,331483535
zho_Hani-deu_Latn,25986223,30924146,42201666,25986223,299480448,22425349,330404594
bul_Cyrl-ell_Grek,9479365,159062649,8606192,9479365,169335218,8516008,328397867
fin_Latn-ita_Latn,11446846,135770765,10035558,11446846,192499445,9709011,328270210
ces_Latn-ron_Latn,10371825,146279515,9031743,10371825,177480065,9055667,323759580
ell_Grek-pol_Latn,10419516,174261899,9069488,10419516,146857390,9472334,321119289
est_Latn-fra_Latn,11759971,131096639,9951030,11759971,186930859,9504750,318027498
eng_Latn-isl_Latn,14836221,161448161,28791296,14836221,155739128,11890303,317187289
deu_Latn-fas_Arab,13202989,147897299,11668875,13202989,168005707,9636848,315903006
ara_Arab-fin_Latn,21392227,173509828,11471218,21392227,140837492,19676304,314347320
spa_Latn-est_Latn,11438249,183326197,9540727,11438249,129999894,9755492,313326091
fin_Latn-nld_Latn,11357829,129593574,10052133,11357829,182800779,9819253,312394353
ara_Arab-dan_Latn,16369121,150075146,9806392,16369121,161846340,15499386,311921486
ces_Latn-hun_Latn,11331033,156662301,9710820,11331033,154256266,9895442,310918567
fin_Latn-por_Latn,10849045,127386464,9591889,10849045,182787236,9578379,310173700
ara_Arab-hrv_Latn,21558930,152364658,10105381,21558930,154679095,20968542,307043753
amh_Ethi-eng_Latn,15582214,126218999,3553163,15582214,179307150,31378350,305526149
spa_Latn-srp_Cyrl,12587431,163560054,10153432,12587431,140478071,10145248,304038125
ast_Latn-spa_Latn,6469787,148341270,6877606,6469787,154146582,6955815,302487852
ceb_Latn-eng_Latn,14768136,154447682,11825303,14768136,146493680,29797287,300941362
bul_Cyrl-slk_Latn,13338153,157418410,10571201,13338153,141070548,10516737,298488958
eng_Latn-glg_Latn,14007221,149007435,26256383,14007221,148545659,10536814,297553094
eng_Latn-pus_Arab,11696271,130992251,23141039,11696271,163301057,8906863,294293308
fra_Latn-srp_Cyrl,12327745,159701607,9592448,12327745,132153898,9825897,291855505
eng_Latn-ben_Beng,14488900,149923690,27265601,14488900,139585563,18158898,289509253
cat_Latn-por_Latn,12674365,144669857,9598178,12674365,139751570,9537618,284421427
ell_Grek-swe_Latn,9052611,149255918,7870488,9052611,133351836,7829619,282607754
ces_Latn-ell_Grek,9108956,128132112,7995777,9108956,153767847,7960340,281899959
ara_Arab-fas_Arab,12125633,127790234,7728567,12125633,153975592,8205712,281765826
fra_Latn-lav_Latn,9306433,145121174,7232828,9306433,132280202,10103747,277401376
ara_Arab-slv_Latn,17594526,140422886,9259853,17594526,136766911,16655274,277189797
spa_Latn-sqi_Latn,10586564,137327899,8367169,10586564,139170669,7877811,276498568
eng_Latn-tgk_Cyrl,13747259,153358981,27859964,13747259,122923094,10172041,276282075
spa_Latn-lav_Latn,9150110,143088775,7337089,9150110,130421226,9956294,273510001
eng_Latn-som_Latn,10937477,121893111,21395231,10937477,149946325,9399909,271839436
deu_Latn-hin_Deva,9198069,121257882,7503746,9198069,148028139,1969552,269286021
ces_Latn-slv_Latn,9880191,133032400,8299949,9880191,136167241,8199487,269199641
spa_Latn-hin_Deva,11724545,125344443,9191285,11724545,141929472,1491796,267273915
bul_Cyrl-swe_Latn,8850508,137023458,7695660,8850508,129729173,7591960,266752631
dan_Latn-fin_Latn,9481818,150092960,8864693,9481818,114284589,8521439,264377549
deu_Latn-srp_Cyrl,11982495,137899308,9622913,11982495,126034883,9532049,263934191
eng_Latn-pan_Guru,11385087,128709534,22808893,11385087,131202508,4629666,259912042
fra_Latn-hrv_Latn,9152786,143270106,7338532,9152786,116278720,7988838,259548826
deu_Latn-kor_Hang,14500860,139693735,11463344,14500860,116582397,10419420,256276132
dan_Latn-ron_Latn,7745344,121633008,7051198,7745344,134493344,6781864,256126352
dan_Latn-ell_Grek,7579341,122239204,7064249,7579341,133621073,6712842,255860277
deu_Latn-zho_Hani,18166621,223497229,15162566,18166621,30596417,31569029,254093646
bul_Cyrl-hun_Latn,8298137,135164970,7240552,8298137,117699555,7413128,252864525
guj_Gujr-tel_Telu,8921292,136260270,7992435,8921292,114738024,8414864,250998294
fra_Latn-hin_Deva,11320527,120071492,8462380,11320527,130780080,1570340,250851572
ara_Arab-nor_Latn,11814167,122017121,7698221,11814167,128682419,10760669,250699540
eng_Latn-ori_Orya,13855319,124010624,27588697,13855319,126081496,2012005,250092120
eng_Latn-sun_Latn,12519533,133862965,27538241,12519533,115684553,13639878,249547518
eng_Latn-kat_Geor,12641894,149694974,27530693,12641894,99658124,10000266,249353098
cat_Latn-ita_Latn,11444494,126495026,8484541,11444494,121407192,8276064,247902218
deu_Latn-ukr_Cyrl,10529247,129469289,8869328,10529247,116177028,8488788,245646317
bul_Cyrl-dan_Latn,7568256,124603742,6674182,7568256,120474300,6923187,245078042
guj_Gujr-kan_Knda,8743377,137457456,7926183,8743377,107617698,8086387,245075154
fin_Latn-pol_Latn,9961642,110428800,8604263,9961642,133569255,8869081,243998055
eng_Latn-afr_Latn,10434862,119489998,20120199,10434862,123359573,8000305,242849571
deu_Latn-sqi_Latn,10765912,115755731,8518163,10765912,125818365,8007903,241574096
eng_Latn-pap_Latn,15232832,120668684,28621141,15232832,120789324,9042813,241458008
fas_Arab-fra_Latn,8300559,120995619,6568656,8300559,120226092,6811216,241221711
zho_Hani-ita_Latn,18001568,21048704,28034167,18001568,219443513,15820439,240492217
ara_Arab-slk_Latn,12014522,120457829,7720154,12014522,119619306,11118261,240077135
ell_Grek-slk_Latn,7615727,130006932,6510130,7615727,108997394,6607029,239004326
ell_Grek-hun_Latn,7598499,130531634,6590901,7598499,107537469,6842761,238069103
bul_Cyrl-slv_Latn,9938057,123052817,7968335,9938057,111877730,7784835,234930547
bul_Cyrl-fra_Latn,10329206,110666545,8641747,10329206,123688835,8020752,234355380
spa_Latn-ukr_Cyrl,8623095,129889368,7176143,8623095,103732250,6997235,233621618
dan_Latn-slk_Latn,7894427,121437434,7019804,7894427,111946991,6788919,233384425
est_Latn-rus_Cyrl,10124260,108819297,8790889,10124260,123745602,8638134,232564899
fas_Arab-por_Latn,9839199,120091011,7132406,9839199,112406395,7918194,232497406
eng_Latn-snd_Arab,10733207,108404349,20910021,10733207,121862093,8208099,230266442
dan_Latn-hun_Latn,7728854,120852684,6996740,7728854,109023252,6971580,229875936
bul_Cyrl-spa_Latn,9584380,107804000,7825757,9584380,119256069,7520771,227060069
ind_Latn-nep_Deva,6563010,115590633,6735729,6563010,108758067,494545,224348700
ces_Latn-fin_Latn,8902694,120420065,7744687,8902694,100386461,7751011,220806526
ces_Latn-tur_Latn,14350528,113042451,10712201,14350528,103209349,10638398,216251800
bul_Cyrl-lit_Latn,7060660,118633313,6294402,7060660,96078891,6560359,214712204
fin_Latn-rus_Cyrl,10346444,95966975,8564387,10346444,114346889,8499147,210313864
est_Latn-ita_Latn,7098249,88674206,6239732,7098249,120144867,5975330,208819073
ces_Latn-ita_Latn,10016229,95924444,7653781,10016229,112026574,7187752,207951018
ces_Latn-vie_Latn,9949219,83138094,7662498,9949219,124204273,6616717,207342367
heb_Hebr-por_Latn,11270874,91600071,7968388,11270874,114541657,8486782,206141728
ell_Grek-vie_Latn,8446884,89473764,6584632,8446884,116391759,5861537,205865523
ces_Latn-nor_Latn,8008342,98343193,6845320,8008342,107468917,6809715,205812110
eng_Latn-kin_Latn,10180433,108689757,20076702,10180433,97094963,7576554,205784720
fin_Latn-nor_Latn,8111868,88487425,7086472,8111868,114513452,7080260,203000877
ces_Latn-lit_Latn,7453241,104582234,6456032,7453241,96649387,6784675,201231621
est_Latn-por_Latn,6718896,83650413,5947355,6718896,114265596,5961415,197916009
ara_Arab-est_Latn,12526333,102126816,6803502,12526333,95331982,11800963,197458798
fin_Latn-hun_Latn,7815387,90207173,6805812,7815387,106671329,7046454,196878502
ell_Grek-ind_Latn,8962679,104101244,7358042,8962679,92673860,7257237,196775104
est_Latn-nld_Latn,6883449,83524028,6139720,6883449,112827800,5948456,196351828
ell_Grek-slv_Latn,6060419,105961445,5203114,6060419,90192022,5185328,196153467
dan_Latn-slv_Latn,6370040,101020797,5725461,6370040,94419239,5410356,195440036
deu_Latn-mlt_Latn,5284286,100291994,5166010,5284286,94629365,4444702,194921359
ara_Arab-hin_Deva,7116418,86610095,5518297,7116418,106397378,1865074,193007473
fra_Latn-ukr_Cyrl,7644724,107515099,6043095,7644724,84610804,6046583,192125903
afr_Latn-fra_Latn,9582945,89249983,7257306,9582945,99745996,7987062,188995979
eng_Latn-uig_Arab,9952068,107929172,21449179,9952068,80630110,8210253,188559282
fin_Latn-slk_Latn,7435826,85311929,6368092,7435826,103201126,6387916,188513055
eng_Latn-tat_Cyrl,10642379,104094496,20618811,10642379,84180974,7590343,188275470
zho_Hani-vie_Latn,10596305,12761530,16856606,10596305,174727202,8042625,187488732
zho_Hani-nld_Latn,16323773,18576848,24508514,16323773,168552579,14838721,187129427
ell_Grek-tur_Latn,10812515,103601420,8191767,10812515,81366531,8299760,184967951
eng_Latn-bos_Latn,12260603,100216376,27784993,12260603,84594635,11943885,184811011
fin_Latn-ron_Latn,6422326,75105367,5642957,6422326,109376639,5628194,184482006
hrv_Latn-rus_Cyrl,7704981,92054357,6662306,7704981,90057941,6474336,182112298
ell_Grek-fin_Latn,6278460,107213429,5509949,6278460,74816916,5553562,182030345
bul_Cyrl-fin_Latn,6460973,104404067,5704159,6460973,76801143,5695689,181205210
est_Latn-pol_Latn,7021492,83887233,6131422,7021492,96817129,6385662,180704362
ces_Latn-est_Latn,6651015,94197226,5866472,6651015,82357213,5867238,176554439
dan_Latn-lit_Latn,5780664,94746232,5389763,5780664,80223638,5393509,174969870
bul_Cyrl-srp_Cyrl,8651654,90389405,6892329,8651654,84512879,6829442,174902284
ara_Arab-urd_Arab,7369578,71105146,4937995,7369578,103246060,2939229,174351206
eng_Latn-sna_Latn,9467871,98148655,18556543,9467871,76093429,7329823,174242084
bul_Cyrl-nor_Latn,6135910,87724989,5323257,6135910,85817929,5258913,173542918
ell_Grek-nor_Latn,5882831,89046039,5134517,5882831,81508051,5070278,170554090
ell_Grek-lit_Latn,5391304,95879449,4778900,5391304,73857993,5097941,169737442
bul_Cyrl-est_Latn,5568939,95023975,4990104,5568939,72711128,4979322,167735103
eng_Latn-mya_Mymr,10415914,107543275,20939333,10415914,59137770,2419936,166681045
spa_Latn-swa_Latn,6945151,85171691,5514420,6945151,81134847,5561589,166306538
eng_Latn-xho_Latn,9256785,95387160,18008117,9256785,69782032,6894022,165169192
bul_Cyrl-vie_Latn,4732277,68430276,4197621,4732277,96149720,3895923,164579996
est_Latn-swe_Latn,6154998,74266276,5392875,6154998,89772053,5329829,164038329
eng_Latn-smo_Latn,6432883,70623774,12668257,6432883,93394569,4897015,164018343
ben_Beng-fra_Latn,10004240,74623167,12361951,10004240,89264306,7381030,163887473
eng_Latn-mri_Latn,5997643,71791442,11731388,5997643,91380889,4435611,163172331
deu_Latn-mkd_Cyrl,7792724,81305069,6745084,7792724,81838123,6505555,163143192
dan_Latn-est_Latn,5423031,89385548,5162697,5423031,71231298,4949657,160616846
eng_Latn-gla_Latn,6825355,77061723,13572215,6825355,83274863,5114001,160336586
ces_Latn-ind_Latn,6211186,77890977,5433603,6211186,81937243,5349147,159828220
fin_Latn-slv_Latn,6001328,71403855,5172773,6001328,87661612,5122562,159065467
bul_Cyrl-ukr_Cyrl,8083774,83974296,6507543,8083774,74806289,6171141,158780585
est_Latn-slk_Latn,5762139,73409639,4996262,5762139,84773101,5046803,158182740
spa_Latn-tam_Taml,9143266,90854364,7960704,9143266,66246611,8323573,157100975
spa_Latn-kor_Hang,9794578,88961432,7982211,9794578,67984849,7166530,156946281
eng_Latn-ibo_Latn,6340833,71828700,12064405,6340833,85109882,5084603,156938582
heb_Hebr-nld_Latn,9509446,69567065,6882515,9509446,87269271,7132345,156836336
eng_Latn-tgl_Latn,9772754,75155109,15771302,9772754,81540216,5534905,156695325
spa_Latn-mkd_Cyrl,5913345,81009323,4757620,5913345,74604743,4660057,155614066
dan_Latn-ind_Latn,5599135,80160334,4985062,5599135,75315965,4871411,155476299
est_Latn-lit_Latn,5647307,74700652,5119386,5647307,79606243,5362836,154306895
eng_Latn-lus_Latn,6974984,70889255,14394026,6974984,83332032,6020373,154221287
fin_Latn-vie_Latn,7648640,56586574,5908508,7648640,97629373,4995730,154215947
fra_Latn-kor_Hang,9623936,88521945,7494194,9623936,65001587,7234009,153523532
epo_Latn-spa_Latn,5750087,73307203,4564134,5750087,80081966,4749744,153389169
eng_Latn-eus_Latn,9459296,84571249,18328454,9459296,68695212,7159797,153266461
est_Latn-slv_Latn,5302529,70355299,4680396,5302529,82416267,4636563,152771566
eng_Latn-yid_Hebr,7613148,77766636,15722722,7613148,74816966,5942172,152583602
deu_Latn-msa_Latn,7096455,76503282,5770758,7096455,76010634,5709078,152513916
fas_Arab-nld_Latn,7444725,78393698,5250462,7444725,73364946,5806745,151758644
hin_Deva-por_Latn,6323458,81442483,807918,6323458,70103312,4968806,151545795
est_Latn-ron_Latn,4955878,63432084,4420181,4955878,88002334,4358899,151434418
zho_Hani-pol_Latn,15673433,17657705,22926761,15673433,133714202,13669754,151371907
bul_Cyrl-lav_Latn,4919016,80856764,4232170,4919016,70236049,5317154,151092813
fas_Arab-ind_Latn,6392415,81056874,4780571,6392415,68403044,5178281,149459918
bak_Cyrl-eng_Latn,8177542,69308781,7468634,8177542,79771726,16600975,149080507
est_Latn-fin_Latn,6045676,76117543,5458664,6045676,72745181,5453574,148862724
bul_Cyrl-por_Latn,6689649,71973512,5406656,6689649,76024870,5214959,147998382
ces_Latn-lav_Latn,5298586,72197363,4442507,5298586,75599205,5746495,147796568
dan_Latn-rus_Cyrl,8481552,77538869,6781395,8481552,70060985,6623203,147599854
est_Latn-hun_Latn,5475249,69053195,4828207,5475249,77975256,5026299,147028451
fin_Latn-ind_Latn,8120931,65515517,6633346,8120931,79635206,6427965,145150723
fra_Latn-tam_Taml,8186107,85435024,6699322,8186107,59650038,7426763,145085062
zho_Hani-ron_Latn,13659150,14501334,19273425,13659150,130046073,12560395,144547407
fra_Latn-oci_Latn,9322845,76400175,7736426,9322845,67905820,8103154,144305995
zho_Hani-ces_Latn,15340196,16916132,22122665,15340196,126989053,13700459,143905185
deu_Latn-isl_Latn,6843981,72325456,5424842,6843981,71469834,5507276,143795290
ell_Grek-est_Latn,4652938,82692059,4142260,4652938,60202037,4202241,142894096
hrv_Latn-srp_Cyrl,4861450,70712729,4502136,4861450,71211007,4466528,141923736
fas_Arab-vie_Latn,5636830,64051068,3797360,5636830,77589961,4027839,141641029
zho_Hani-swe_Latn,13261607,15537609,20023285,13261607,124191346,11017337,139728955
ces_Latn-srp_Cyrl,6141116,68424516,5096332,6141116,71189463,5093610,139613979
fas_Arab-rus_Cyrl,5521250,76471015,4203924,5521250,61909158,4587681,138380173
fin_Latn-lit_Latn,5428457,65244675,4790929,5428457,72470091,5033039,137714766
fas_Arab-ita_Latn,4460860,71222565,3660358,4460860,66102908,3791298,137325473
heb_Hebr-swe_Latn,8767830,63743722,6188328,8767830,73493896,6428781,137237618
zho_Hani-tur_Latn,16456260,19305287,23409754,16456260,116981273,14033334,136286560
hrv_Latn-pol_Latn,5231263,68168066,4591757,5231263,67108460,4510104,135276526
ara_Arab-kor_Hang,6943527,72302348,4663516,6943527,62226396,4770827,134528744
eng_Latn-khm_Khmr,6330915,71027413,12774515,6330915,63424175,1577093,134451588
ara_Arab-lit_Latn,5903110,69911765,4440455,5903110,63764743,5385667,133676508
fra_Latn-swa_Latn,5647316,70779967,4851681,5647316,61375046,4667620,132155013
nep_Deva-tur_Latn,4861387,67578840,530645,4861387,63113642,4908155,130692482
fas_Arab-pol_Latn,7107075,72061861,4800972,7107075,58494341,5585981,130556202
zho_Hani-ell_Grek,12887817,13956364,18219694,12887817,116282256,12000131,130238620
heb_Hebr-rus_Cyrl,8870353,62400809,6166943,8870353,67554609,6642997,129955418
heb_Hebr-pol_Latn,8811988,62661831,6132252,8811988,67148812,6564223,129810643
ell_Grek-lav_Latn,4068781,71051693,3484114,4068781,58131723,4408898,129183416
zho_Hani-bul_Cyrl,13167096,13739809,18725788,13167096,115111353,11693666,128851162
dan_Latn-vie_Latn,4001755,53034760,3391481,4001755,74427156,3134330,127461916
eng_Latn-lmo_Latn,8734893,66889065,18688853,8734893,60131118,5495199,127020183
dan_Latn-lav_Latn,4175835,66446858,3757910,4175835,59639639,4523552,126086497
ara_Arab-msa_Latn,5976871,61688702,4174600,5976871,63070470,5110983,124759172
dan_Latn-tur_Latn,5521307,68632825,4535271,5521307,55980399,4541184,124613224
bul_Cyrl-hrv_Latn,4090959,65363243,3559280,4090959,59087701,3752317,124450944
guj_Gujr-mal_Mlym,5133595,70028138,4496743,5133595,54071607,4771666,124099745
hrv_Latn-slv_Latn,4179846,61878235,3858522,4179846,61981764,3591207,123859999
eng_Latn-war_Latn,9657405,61936073,18630426,9657405,60432045,6043457,122368118
ell_Grek-srp_Cyrl,4590825,65433018,3950390,4590825,56716323,3933897,122149341
zho_Hani-ind_Latn,10523099,11633123,16339102,10523099,107612137,8989360,119245260
hrv_Latn-ron_Latn,3745558,54053305,3415921,3745558,64050362,3192847,118103667
ces_Latn-hrv_Latn,4462012,57983288,3758825,4462012,59576890,3934541,117560178
cat_Latn-ron_Latn,5831036,59353357,4348527,5831036,57521949,4269577,116875306
hun_Latn-ind_Latn,4524658,56547711,3903052,4524658,60123417,3864142,116671128
eng_Latn-tha_Thai,8901559,70247420,14465347,8901559,45881091,3086535,116128511
ara_Arab-sqi_Latn,4938077,51346811,3305086,4938077,61778858,4154723,113125669
deu_Latn-epo_Latn,5333778,56767775,4352428,5333778,55641758,4077456,112409533
est_Latn-lav_Latn,4110576,53555758,3595081,4110576,58829794,4455080,112385552
dan_Latn-pol_Latn,5890089,58559728,4746258,5890089,53793271,4699924,112352999
ben_Beng-deu_Latn,5821919,55354881,7598875,5821919,56512304,4384471,111867185
eng_Latn-mlg_Latn,4734097,55318793,9365436,4734097,56022545,3855890,111341338
heb_Hebr-vie_Latn,5998868,43232631,4163220,5998868,67615637,3887093,110848268
ara_Arab-ukr_Cyrl,4793387,55271388,3476456,4793387,54173135,3934724,109444523
ell_Grek-heb_Hebr,6266806,58849081,4777264,6266806,47729441,4484091,106578522
hrv_Latn-slk_Latn,3791201,53623897,3415621,3791201,52789026,3219997,106412923
afr_Latn-deu_Latn,4452200,54489812,3454752,4452200,51607883,3577972,106097695
zho_Hani-hun_Latn,12364516,13698674,17173891,12364516,91978210,10444926,105676884
hin_Deva-tur_Latn,5507780,63056176,754321,5507780,42570823,4362156,105626999
heb_Hebr-tur_Latn,7611205,53633097,5092203,7611205,51747432,5502088,105380529
est_Latn-nor_Latn,4233392,47235807,3672212,4233392,57895925,3667942,105131732
zho_Hani-dan_Latn,10238052,11369405,15080883,10238052,93495460,8964845,104864865
heb_Hebr-ind_Latn,6088851,48478906,4490245,6088851,54345550,4659106,102824456
fin_Latn-tur_Latn,5329927,49646948,4433855,5329927,52945507,4442021,102592455
hin_Deva-ita_Latn,3182730,54280552,378260,3182730,47071602,2574375,101352154
dan_Latn-srp_Cyrl,4094303,52736024,3416810,4094303,48436506,3425278,101172530
ara_Arab-xho_Latn,1140803,10665146,524393,1140803,90345037,120241,101010183
eng_Latn-hau_Latn,3893234,48614080,7446970,3893234,52276887,2999487,100890967
ara_Arab-lav_Latn,4026489,48618808,3048512,4026489,51602495,3996264,100221303
fin_Latn-lav_Latn,3858727,44997704,3290179,3858727,55111935,4186220,100109639
eng_Latn-tsn_Latn,6345505,45305789,12303859,6345505,54563402,3521607,99869191
ces_Latn-dan_Latn,5301895,47354112,4245521,5301895,52211610,4316198,99565722
ara_Arab-bos_Latn,8075830,49131136,3308277,8075830,50386650,8194134,99517786
ara_Arab-zho_Hani,6413736,87321437,5003776,6413736,10089822,11237862,97411259
amh_Ethi-fra_Latn,4292684,38048137,985504,4292684,59311364,3837627,97359501
ara_Arab-ben_Beng,5243858,48895647,3589446,5243858,47971867,7024250,96867514
bul_Cyrl-mkd_Cyrl,3246675,47760429,2847320,3246675,48877098,2724289,96637527
ast_Latn-eng_Latn,2956540,57804314,2994848,2956540,37681491,5916795,95485805
fra_Latn-msa_Latn,4366441,51274086,3210577,4366441,43634263,3281851,94908349
hin_Deva-ind_Latn,4016107,52979753,512015,4016107,41476380,3214838,94456133
fra_Latn-hau_Latn,3516177,45454374,2634811,3516177,48719484,2884856,94173858
fra_Latn-hat_Latn,3982056,48152093,3329940,3982056,45895116,3090310,94047209
cat_Latn-glg_Latn,3041119,47096679,2412783,3041119,45002965,2420005,92099644
hin_Deva-rus_Cyrl,3513010,52325919,384864,3513010,39458328,2892970,91784247
ces_Latn-kor_Hang,6713151,48349407,5273912,6713151,43248382,4823459,91597789
ara_Arab-nep_Deva,2694377,47904289,2252006,2694377,43142007,355927,91046296
fas_Arab-tur_Latn,4032720,52867322,3072455,4032720,37866996,3349893,90734318
ces_Latn-ukr_Cyrl,3991915,45130301,3324034,3991915,45105320,3222650,90235621
zho_Hani-srp_Latn,10799302,11167669,14953189,10799302,78107343,9902832,89275012
zho_Hani-heb_Hebr,11788465,12727210,16126280,11788465,76376575,10106852,89103785
hrv_Latn-hun_Latn,3306074,45309231,2935790,3306074,43592689,2811541,88901920
fas_Arab-swe_Latn,3291996,47761885,2641134,3291996,40537623,2747156,88299508
eng_Latn-zul_Latn,4754773,50799848,9306668,4754773,36868131,3713257,87667979
asm_Beng-eng_Latn,5161042,43731661,6293531,5161042,43758369,10175004,87490030
heb_Hebr-hun_Latn,5746866,42632474,3912730,5746866,44774444,4110765,87406918
ell_Grek-sqi_Latn,3206256,42829393,2665114,3206256,44306052,2514738,87135445
fra_Latn-mlg_Latn,3629830,45689295,3065904,3629830,41351453,2830169,87040748
eng_Latn-fij_Latn,3853668,38103221,7489232,3853668,48822171,2726510,86925392
bul_Cyrl-sqi_Latn,3177160,40936137,2665268,3177160,45846085,2512404,86782222
hin_Deva-nld_Latn,2828574,46064410,328904,2828574,40407176,2283428,86471586
ben_Beng-urd_Arab,4137069,35736032,5246930,4137069,49643455,1159483,85379487
hin_Deva-vie_Latn,3285286,40201491,530569,3285286,45067299,2265204,85268790
glg_Latn-ita_Latn,4023754,42490452,2874944,4023754,42761012,2796652,85251464
est_Latn-ind_Latn,3420806,39208763,3064104,3420806,45798807,3001496,85007570
ben_Beng-por_Latn,5112665,39769305,6202686,5112665,44685139,3918468,84454444
guj_Gujr-mar_Deva,3626916,42764711,2995816,3626916,41157683,3065400,83922394
dan_Latn-hrv_Latn,2935197,43377849,2550999,2935197,40455102,2648243,83832951
est_Latn-srp_Cyrl,3387059,38840402,2922791,3387059,44378832,2953335,83219234
bul_Cyrl-tur_Latn,5385896,45226153,4197804,5385896,37193491,4105869,82419644
ara_Arab-srp_Cyrl,3283267,40966598,2686408,3283267,41303447,2811191,82270045
zho_Hani-nor_Latn,7535798,8494350,11552930,7535798,72939653,6180470,81434003
zho_Hani-fin_Latn,10837166,11890370,15297796,10837166,69531751,9218569,81422121
eng_Latn-ewe_Latn,4423992,40435063,8724963,4423992,40887862,2510936,81322925
fin_Latn-heb_Hebr,5630335,38705947,4315375,5630335,41704335,3999815,80410282
hrv_Latn-lit_Latn,2897936,42002011,2642934,2897936,37937021,2591561,79939032
ben_Beng-tel_Telu,5188938,42077812,6445696,5188938,37619019,4060519,79696831
fas_Arab-nep_Deva,2057851,45527753,1874259,2057851,33791946,277013,79319699
fra_Latn-som_Latn,2817860,36353172,2284882,2817860,42930392,2580343,79283564
fas_Arab-ron_Latn,2694922,40057374,2208642,2694922,38938585,2373711,78995959
eng_Latn-fao_Latn,2896414,40608783,5865311,2896414,38079731,2275069,78688514
zho_Hani-hrv_Latn,9550596,9970953,12826605,9550596,68181769,8731316,78152722
eng_Latn-vec_Latn,4964395,39427624,9794653,4964395,38701432,3306897,78129056
deu_Latn-swa_Latn,3198757,39707634,2465290,3198757,37695792,2496099,77403426
zho_Hani-slv_Latn,9227541,9821259,12764137,9227541,67421172,7972324,77242431
bul_Cyrl-heb_Hebr,3331897,41746758,2767833,3331897,34822242,2616731,76569000
fra_Latn-ltz_Latn,3661816,41201802,2866838,3661816,35192381,2648325,76394183
zho_Hani-fas_Arab,7266131,8075562,10765514,7266131,68140582,4610999,76216144
ara_Arab-cat_Latn,3147674,34525324,2273056,3147674,41486132,2573537,76011456
ces_Latn-heb_Hebr,3772738,38970417,3023365,3772738,36421652,2857419,75392069
heb_Hebr-ron_Latn,3163236,32232684,2448011,3163236,42968878,2622284,75201562
fin_Latn-srp_Cyrl,3564663,34037135,2948979,3564663,41012528,2951682,75049663
fra_Latn-zul_Latn,3615801,44697157,3133552,3615801,30127662,2980070,74824819
ces_Latn-zho_Hani,6399505,65179805,5096258,6399505,9585004,10947163,74764809
heb_Hebr-nor_Latn,3262230,34005766,2577164,3262230,40303820,2666167,74309586
ben_Beng-spa_Latn,3838856,34319996,4627892,3838856,39877874,2951756,74197870
hin_Deva-swe_Latn,2539316,40837278,308986,2539316,33069477,2000883,73906755
ell_Grek-fas_Arab,2566359,35861002,2229836,2566359,38011511,2086067,73872513
ben_Beng-tur_Latn,5045128,38664295,6233665,5045128,34434278,3923550,73098573
zho_Hani-slk_Latn,7455582,8436594,11281411,7455582,64498079,6067415,72934673
est_Latn-vie_Latn,2553387,26832063,2181361,2553387,46000566,2001942,72832629
bos_Latn-deu_Latn,5342039,33920093,5274365,5342039,38316193,5314674,72236286
guj_Gujr-urd_Arab,2648928,28098807,2049561,2648928,43704304,1147133,71803111
dan_Latn-heb_Hebr,3208992,39216934,2653482,3208992,32567429,2518555,71784363
ces_Latn-fas_Arab,2884637,31398759,2422846,2884637,39739876,2265383,71138635
ces_Latn-sqi_Latn,3152495,31476559,2480065,3152495,39050292,2328518,70526851
eng_Latn-lao_Laoo,4306552,41043153,8486434,4306552,28775058,2394400,69818211
ell_Grek-hin_Deva,3268809,32088961,2585308,3268809,37353520,482690,69442481
kor_Hang-zho_Hani,6942367,58178551,4416208,6942367,10791206,10540436,68969757
ara_Arab-som_Latn,2812341,27765542,1825982,2812341,41173267,2486052,68938809
ell_Grek-zho_Hani,4852590,61401399,3949436,4852590,7146533,8438582,68547932
eng_Latn-bel_Cyrl,2678524,33874264,5332966,2678524,34528445,2336041,68402709
bul_Cyrl-zho_Hani,5106840,61243882,4252482,5106840,6944797,8924640,68188679
eng_Latn-lim_Latn,4322586,36149184,8848587,4322586,31705851,2508658,67855035
ell_Grek-ukr_Cyrl,2662888,36404967,2253752,2662888,30423023,2189058,66827990
eng_Latn-mai_Deva,4438216,31677601,8358647,4438216,35116505,882789,66794106
fas_Arab-heb_Hebr,4054112,37778550,2610185,4054112,28982479,2795764,66761029
heb_Hebr-slk_Latn,3201108,32102380,2416402,3201108,34361118,2513164,66463498
eng_Latn-ast_Latn,2217013,30697603,4454682,2217013,35216451,2134337,65914054
est_Latn-hrv_Latn,2353067,30291677,2071719,2353067,35409376,2217410,65701053
eng_Latn-twi_Latn,4045475,33502442,7802940,4045475,32122608,2094740,65625050
hin_Deva-pol_Latn,2417787,37525311,290824,2417787,27801285,1942090,65326596
fra_Latn-yor_Latn,2646387,31800028,2123082,2646387,33311966,2152800,65111994
glg_Latn-tur_Latn,4497017,35893068,3123753,4497017,29009598,3127903,64902666
est_Latn-tur_Latn,3306690,32169830,2746232,3306690,32111927,2762731,64281757
eng_Latn-kab_Latn,4166392,34235503,8545412,4166392,29937424,2461059,64172927
bul_Cyrl-ind_Latn,3530182,32792094,2908609,3530182,31119281,2744806,63911375
ben_Beng-tam_Taml,4262645,34429905,5385715,4262645,29464425,3060986,63894330
fas_Arab-nor_Latn,2311749,34330626,1859717,2311749,29511614,1955038,63842240
ben_Beng-mal_Mlym,4628921,34884209,5699882,4628921,28346274,3607056,63230483
fas_Arab-hin_Deva,2734470,30453924,2040667,2734470,32569412,382803,63023336
fra_Latn-kin_Latn,2659711,34100295,2235888,2659711,28896175,2096446,62996470
eng_Latn-sag_Latn,3607360,26362575,7098013,3607360,35688137,2435886,62050712
epo_Latn-ita_Latn,2545856,30340116,1944353,2545856,31582916,1977736,61923032
eng_Latn-lug_Latn,3602674,32787720,6855283,3602674,28968399,2347418,61756119
cat_Latn-ell_Grek,2484651,31103738,1966117,2484651,30207153,1970540,61310891
zho_Hani-est_Latn,7586995,8021771,10638234,7586995,53055404,6649734,61077175
ben_Beng-kan_Knda,3992740,32925504,4935677,3992740,28111127,2879437,61036631
fin_Latn-hrv_Latn,2527759,27415272,2122366,2527759,33429600,2258224,60844872
dan_Latn-ukr_Cyrl,2498607,31882401,2125277,2498607,28751917,2056046,60634318
eng_Latn-aze_Latn,2650706,33482899,4900561,2650706,26858940,2141626,60341839
fra_Latn-nya_Latn,2495285,33514007,2250826,2495285,26531151,2162563,60045158
eng_Latn-hbs_Latn,1529879,31419180,2900576,1529879,28327394,1905970,59746574
hin_Deva-hun_Latn,3129544,34445878,433209,3129544,25272780,2387235,59718658
dan_Latn-zho_Hani,4778216,52032064,3843525,4778216,7027400,8227761,59059464
heb_Hebr-lit_Latn,3898223,29489175,2737773,3898223,29496547,3049786,58985722
afr_Latn-nld_Latn,2325478,29372831,1825161,2325478,29121955,1845781,58494786
hrv_Latn-nor_Latn,2475209,27949515,2052727,2475209,30165235,2012202,58114750
fin_Latn-hin_Deva,3107875,22742821,2501850,3107875,35117148,390962,57859969
dan_Latn-fas_Arab,2151870,26798064,1851923,2151870,30713491,1732447,57511555
ara_Arab-kur_Arab,2782025,27971304,2020166,2782025,29534951,1609140,57506255
deu_Latn-tgl_Latn,2668048,26259359,1713613,2668048,30555209,1748965,56814568
hrv_Latn-lav_Latn,1978107,28391615,1792192,1978107,28183690,2145771,56575305
bul_Cyrl-hin_Deva,1854659,25355066,1567452,1854659,30823130,210427,56178196
cat_Latn-deu_Latn,2075928,29388311,1809028,2075928,25921299,1835270,55309610
ben_Beng-mar_Deva,3809116,27623646,4712007,3809116,27652255,2510465,55275901
bel_Cyrl-pol_Latn,2295783,26045364,2052362,2295783,29220863,2131674,55266227
eng_Latn-que_Latn,2875100,33052709,5591250,2875100,21948515,2101847,55001224
eng_Latn-nso_Latn,3455711,25573894,6537237,3455711,29109658,2060084,54683552
ces_Latn-mkd_Cyrl,2294713,25399251,1886215,2294713,29277338,1834209,54676589
ben_Beng-ind_Latn,3284824,26777630,3989129,3284824,27683844,2546035,54461474
dan_Latn-sqi_Latn,2281010,25847985,1790073,2281010,28497223,1699845,54345208
heb_Hebr-kor_Hang,4327671,27876757,2983943,4327671,26281702,3030970,54158459
fas_Arab-sqi_Latn,1996859,27290567,1538875,1996859,26700686,1522549,53991253
eng_Latn-luo_Latn,2830951,27745163,5571026,2830951,26092248,2108269,53837411
fas_Arab-slk_Latn,2247751,29857103,1696122,2247751,23762160,1807146,53619263
ben_Beng-guj_Gujr,2814636,27230364,3530006,2814636,25817481,1864701,53047845
fas_Arab-zho_Hani,4598337,45743048,2988325,4598337,7139198,7382068,52882246
ara_Arab-tha_Thai,4329374,32901274,2045596,4329374,19852882,1381461,52754156
eng_Latn-orm_Latn,3257465,25484999,6441589,3257465,27025681,2697205,52510680
fas_Arab-hun_Latn,2142492,29453313,1677530,2142492,22985435,1787986,52438748
fra_Latn-sot_Latn,2291169,24318150,1929766,2291169,28000959,1854779,52319109
hin_Deva-ron_Latn,1753251,27307838,199148,1753251,24803725,1450033,52111563
ben_Beng-hin_Deva,3613054,25581797,4503823,3613054,26262862,505361,51844659
eng_Latn-pag_Latn,3357112,26310869,6450138,3357112,25488542,2121472,51799411
deu_Latn-tam_Taml,2849463,29845904,2201491,2849463,21916546,2196994,51762450
ara_Arab-mkd_Cyrl,3247951,24810777,1606646,3247951,26885191,3137160,51695968
heb_Hebr-slv_Latn,2416711,24685284,1848349,2416711,27008499,1910890,51693783
ces_Latn-hin_Deva,1972384,21905924,1595208,1972384,29618870,231887,51524794
hin_Deva-slk_Latn,1825372,29513386,206732,1825372,21836902,1488948,51350288
dan_Latn-kor_Hang,2470486,28716962,2011483,2470486,22498904,1941232,51215866
ben_Beng-vie_Latn,2762332,21005036,3501022,2762332,30199596,1714767,51204632
hin_Deva-srp_Cyrl,1756451,28985520,177342,1756451,22181399,1462859,51166919
hin_Deva-lit_Latn,2457639,29848681,286708,2457639,20612135,2049862,50460816
heb_Hebr-hin_Deva,2723860,20760887,2019982,2723860,29634920,299251,50395807
cat_Latn-dan_Latn,2176436,26263545,1706547,2176436,24020669,1740023,50284214
heb_Hebr-srp_Cyrl,2448692,23734054,1868033,2448692,26369307,1966638,50103361
bel_Cyrl-tur_Latn,1969948,25846494,1834991,1969948,23636299,1810195,49482793
ben_Beng-nep_Deva,2948999,23913633,3812730,2948999,25395831,581363,49309464
bul_Cyrl-kor_Hang,2353877,27411918,1973071,2353877,21413184,1893629,48825102
eng_Latn-lin_Latn,2934816,24131181,5618283,2934816,24618706,1877837,48749887
hin_Deva-slv_Latn,1651892,27793519,179465,1651892,20896927,1343759,48690446
bul_Cyrl-cat_Latn,2045905,23147452,1641858,2045905,25348571,1607684,48496023
afr_Latn-swa_Latn,2453895,24312457,1575240,2453895,24031561,1613934,48344018
eng_Latn-grn_Latn,2957955,27420429,6015362,2957955,20715974,2276590,48136403
fas_Arab-fin_Latn,2043666,28582469,1622971,2043666,19174794,1776866,47757263
bak_Cyrl-rus_Cyrl,2518510,23710582,2379577,2518510,23751054,2396328,47461636
epo_Latn-nld_Latn,2155882,22619542,1643923,2155882,24180715,1683655,46800257
fas_Arab-urd_Arab,1912593,21910862,1286806,1912593,24642390,489864,46553252
ben_Beng-ell_Grek,3006954,21788052,3673463,3006954,24105641,2311741,45893693
ben_Beng-fas_Arab,2571295,20530402,3160813,2571295,25076881,1832475,45607283
deu_Latn-tha_Thai,3606812,27056988,2187175,3606812,18367286,1294445,45424274
hun_Latn-kor_Hang,2438130,24031704,1952411,2438130,21380730,1896840,45412434
bel_Cyrl-deu_Latn,1377241,27012850,1201776,1377241,18085602,1270629,45098452
fra_Latn-sna_Latn,2261243,26041505,1876670,2261243,19017828,1813229,45059333
aze_Latn-tur_Latn,2313241,22933894,1741775,2313241,21964008,1825246,44897902
ace_Latn-eng_Latn,2443350,22385463,2373522,2443350,22495286,5367764,44880749
fin_Latn-ukr_Cyrl,2253394,20570445,1854737,2253394,24213114,1811979,44783559
ara_Arab-tgl_Latn,1914381,20190108,1308813,1914381,24501947,1534114,44692055
hrv_Latn-mkd_Cyrl,1516986,21308165,1360238,1516986,23259593,1273969,44567758
afr_Latn-tur_Latn,2664488,25015941,2061928,2664488,19470871,2083173,44486812
awa_Deva-eng_Latn,2198978,25394617,477809,2198978,19074618,4292325,44469235
cat_Latn-slk_Latn,1984023,24212495,1523759,1984023,19948334,1531887,44160829
guj_Gujr-ori_Orya,1998286,20803342,1709695,1998286,23257901,222097,44061243
est_Latn-ukr_Cyrl,2049445,20800565,1742413,2049445,23181903,1691522,43982468
afr_Latn-hau_Latn,1915678,19827547,1067639,1915678,24060760,1306968,43888307
ell_Grek-kor_Hang,2134054,25142564,1760505,2134054,18555688,1696074,43698252
ara_Arab-sin_Sinh,2811817,21576473,2020659,2811817,21896960,2422623,43473433
cat_Latn-nor_Latn,1971593,22789514,1527232,1971593,20678679,1533137,43468193
fin_Latn-zho_Hani,4514625,36401920,3589629,4514625,7064751,7600323,43466671
hin_Deva-urd_Arab,2323590,18445786,412678,2323590,25004894,671961,43450680
deu_Latn-mal_Mlym,2825689,26228924,2266270,2825689,17008843,2438363,43237767
eng_Latn-fon_Latn,1915523,19489600,3964745,1915523,23692495,1358615,43182095
fin_Latn-kor_Hang,2411206,21324494,1999379,2411206,21563133,1902737,42887627
fra_Latn-xho_Latn,2192180,25683171,1794189,2192180,17191164,1688111,42874335
fas_Arab-srp_Cyrl,1873459,23405807,1442628,1873459,19367066,1528423,42772873
ben_Beng-hun_Latn,3004291,21780952,3659591,3004291,20882520,2243009,42663472
ara_Arab-mal_Mlym,2733365,23968912,2109010,2733365,18518286,2498459,42487198
guj_Gujr-tam_Taml,2253486,22294150,1745777,2253486,20016644,1903741,42310794
ara_Arab-tam_Taml,2387681,23164690,1878516,2387681,19089285,2153709,42253975
cat_Latn-hun_Latn,1970235,23337446,1498362,1970235,18843631,1497167,42181077
bho_Deva-eng_Latn,2432136,23009787,687680,2432136,19051917,4728831,42061704
zho_Hani-lit_Latn,4508161,4968587,7062509,4508161,37089273,3763075,42057860
afr_Latn-amh_Ethi,1967934,24278082,1465949,1967934,17569407,474947,41847489
fas_Arab-msa_Latn,2229377,22424992,1506962,2229377,19326002,1686295,41750994
zho_Hani-hin_Deva,2911073,3212767,4806628,2911073,38470349,531121,41683116
zho_Hani-lav_Latn,3003158,3208153,4738154,3003158,38290655,3061110,41498808
dan_Latn-mkd_Cyrl,1621002,20373926,1358626,1621002,21063311,1316384,41437237
cat_Latn-ind_Latn,1796329,22323939,1456238,1796329,19109328,1422334,41433267
eng_Latn-tpi_Latn,2162994,19320552,4055508,2162994,22072437,1462012,41392989
ben_Beng-rus_Cyrl,2527543,20596640,3023976,2527543,20691325,1949792,41287965
fas_Arab-slv_Latn,1759799,22769148,1319191,1759799,18440763,1394580,41209911
heb_Hebr-nep_Deva,1437382,20166925,1227031,1437382,20859614,270355,41026539
afr_Latn-swe_Latn,1651577,21326701,1300356,1651577,19593165,1302991,40919866
ara_Arab-swa_Latn,1798968,19826174,1297182,1798968,21046716,1373448,40872890
est_Latn-heb_Hebr,1997037,20091265,1680907,1997037,20649367,1600983,40740632
eng_Latn-san_Deva,3096685,22227408,6067489,3096685,18476992,434888,40704400
eng_Latn-mos_Latn,2197883,18358680,4271107,2197883,22148016,1548794,40506696
heb_Hebr-zho_Hani,4864473,32729961,3318050,4864473,7324763,7731416,40054724
ast_Latn-fra_Latn,1360760,24614490,1309775,1360760,15306574,1085875,39921064
fin_Latn-sqi_Latn,1975902,16396075,1588056,1975902,23422219,1470150,39818294
eng_Latn-kik_Latn,2200605,20711042,4349632,2200605,19049567,1385544,39760609
ben_Beng-ori_Orya,2630902,19235143,3165712,2630902,20437411,344964,39672554
bjn_Latn-ind_Latn,1455317,17507161,2010082,1455317,22162024,3081596,39669185
hau_Latn-nya_Latn,1185704,22757619,1047135,1185704,16832291,1025320,39589910
est_Latn-hin_Deva,1400752,15878183,1210125,1400752,23597884,148489,39476067
fas_Arab-lit_Latn,1585712,22759584,1296870,1585712,16700313,1441182,39459897
eng_Latn-yor_Latn,1689279,18087054,3370433,1689279,21322474,1333933,39409528
glg_Latn-ron_Latn,1836028,18733642,1334812,1836028,20476668,1382867,39210310
cat_Latn-slv_Latn,1661545,21310091,1286309,1661545,17896378,1278374,39206469
hrv_Latn-sqi_Latn,1555250,17893489,1291350,1555250,21251790,1204420,39145279
hrv_Latn-ukr_Cyrl,1787681,19802790,1494412,1787681,19215963,1412382,39018753
epo_Latn-swe_Latn,1878864,19536958,1386980,1878864,19264088,1426640,38801046
heb_Hebr-lav_Latn,1620814,15780413,1219280,1620814,22911670,1755783,38692083
afr_Latn-yor_Latn,1775352,17063675,1074559,1775352,20844904,1260178,37908579
eng_Latn-kon_Latn,2231213,17182508,4313720,2231213,20583343,1294562,37765851
fas_Arab-swa_Latn,1620358,19842879,1212599,1620358,17226109,1323588,37068988
ara_Arab-tat_Cyrl,2106009,19431198,1354014,2106009,17521695,1448942,36952893
ben_Beng-fin_Latn,2781864,19905727,3358243,2781864,16874355,2214905,36780082
afr_Latn-nor_Latn,1359870,18933572,1107252,1359870,17667431,1120224,36601003
eng_Latn-nya_Latn,1660289,19730484,3344525,1660289,16845917,1396943,36576401
eng_Latn-mag_Deva,2221380,16082749,4192259,2221380,20275843,486910,36358592
aze_Latn-ind_Latn,1719995,16119752,1440979,1719995,20071487,1425897,36191239
est_Latn-fas_Arab,1520537,15076532,1330251,1520537,21097088,1235147,36173620
fra_Latn-ibo_Latn,1372169,17177009,1029777,1372169,18840303,1113495,36017312
hin_Deva-kor_Hang,1479915,21629586,194934,1479915,14138488,1133290,35768074
crh_Latn-eng_Latn,1933453,14694535,1541991,1933453,21051455,3874872,35745990
fra_Latn-mal_Mlym,2285148,22290008,1793846,2285148,13434318,1914926,35724326
fra_Latn-scn_Latn,1753086,19051914,1500642,1753086,16641439,1223697,35693353
hin_Deva-lav_Latn,1154278,19016974,102991,1154278,16334737,1251915,35351711
guj_Gujr-nep_Deva,1658465,16767143,1234979,1658465,18452496,413546,35219639
ben_Beng-ita_Latn,1786736,16414400,2178207,1786736,18552497,1325275,34966897
ceb_Latn-mlg_Latn,1201951,18870162,888630,1201951,16085476,879653,34955638
hin_Deva-tel_Telu,2262754,18368284,392896,2262754,16435868,1565785,34804152
ara_Arab-eus_Latn,2626839,17899094,1594683,2626839,16799958,2084086,34699052
zho_Hani-mkd_Cyrl,3449249,3620016,5069259,3449249,30942279,2907370,34562295
afr_Latn-zul_Latn,1771136,19504435,1169277,1771136,15020644,1170932,34525079
fin_Latn-mkd_Cyrl,1506039,14239418,1262036,1506039,19437184,1226859,33676602
fas_Arab-kor_Hang,1561935,19578162,1150136,1561935,13882272,1157626,33460434
cat_Latn-fin_Latn,1756273,19565320,1356400,1756273,13836900,1381949,33402220
ces_Latn-epo_Latn,1631642,15741220,1332724,1631642,17659516,1239154,33400736
ben_Beng-nld_Latn,1749588,15532182,2111494,1749588,17822420,1342299,33354602
hin_Deva-zho_Hani,2210881,30157910,307212,2210881,3144282,3890232,33302192
zho_Hani-ukr_Cyrl,3320330,3827628,5108675,3320330,29460330,2414001,33287958
ell_Grek-swa_Latn,1523353,16566299,1220041,1523353,16472961,1184272,33039260
heb_Hebr-ukr_Cyrl,1770784,15912994,1302365,1770784,17103832,1348501,33016826
bel_Cyrl-ces_Latn,1481637,15559774,1301959,1481637,17178852,1358959,32738626
fas_Arab-tam_Taml,1813268,19742948,1400375,1813268,12833367,1517358,32576315
afr_Latn-som_Latn,1432312,13344035,800486,1432312,18736334,1090468,32080369
est_Latn-sqi_Latn,1425450,13575351,1139408,1425450,18322930,1088190,31898281
deu_Latn-urd_Arab,820812,13834362,821924,820812,17867181,449663,31701543
zho_Hani-msa_Latn,3337135,3646140,4909058,3337135,27847246,2547285,31493386
ben_Beng-pan_Guru,1569638,14710145,2015422,1569638,16662497,560239,31372642
deu_Latn-hbs_Latn,950289,15947210,827894,950289,15406530,1089519,31353740
ara_Arab-uzb_Latn,1152776,28386324,1114883,1152776,2919404,101802,31305728
deu_Latn-ltz_Latn,1129071,13817068,913296,1129071,17418198,432019,31235266
eng_Latn-szl_Latn,1769261,17028081,3660911,1769261,14078812,1377369,31106893
eng_Latn-kbp_Latn,1592155,14843889,3175720,1592155,16080986,1272585,30924875
ben_Beng-heb_Hebr,2310043,16012308,2796188,2310043,14731963,1661718,30744271
guj_Gujr-pan_Guru,1135042,14032356,833528,1135042,16550040,575707,30582396
est_Latn-kor_Hang,1705128,15706658,1437554,1705128,14847441,1393805,30554099
est_Latn-zho_Hani,3101962,26391456,2484498,3101962,4147923,5304095,30539379
hin_Deva-nep_Deva,1710261,15397799,407120,1710261,14924059,504817,30321858
eng_Latn-ful_Latn,1580571,15447217,3238812,1580571,14806173,1358260,30253390
cat_Latn-srp_Cyrl,1443073,16276423,1103738,1443073,13952028,1110223,30228451
epo_Latn-ron_Latn,1298456,14301999,977327,1298456,15817384,1049993,30119383
eng_Latn-kac_Latn,1003087,11837557,2006722,1003087,17918157,860722,29755714
ben_Beng-lit_Latn,2102580,15421964,2516751,2102580,14087070,1734449,29509034
hau_Latn-yor_Latn,795527,14337894,668277,795527,15065678,662197,29403572
ben_Beng-swe_Latn,1570904,14285756,1924261,1570904,15050416,1165009,29336172
heb_Hebr-sqi_Latn,1525049,12543810,1113622,1525049,16601537,1092030,29145347
cat_Latn-sqi_Latn,1248254,14422843,969360,1248254,14603234,905702,29026077
ben_Beng-pus_Arab,1370357,12424169,1716202,1370357,16487790,890558,28911959
ell_Grek-epo_Latn,1262222,14854654,1021150,1262222,14030442,967664,28885096
eng_Latn-sot_Latn,1378523,12993799,2715025,1378523,15884570,1058086,28878369
cat_Latn-lit_Latn,1373081,16330426,1057062,1373081,12389891,1111751,28720317
ara_Arab-isl_Latn,1585999,13699051,915904,1585999,14658061,1517766,28357112
ben_Beng-pol_Latn,1624561,14239782,1978077,1624561,13907348,1231413,28147130
est_Latn-mkd_Cyrl,1137316,12278842,971058,1137316,15866657,945148,28145499
dan_Latn-isl_Latn,1304233,14144848,1045433,1304233,13977450,1065501,28122298
hau_Latn-sot_Latn,840223,13453103,669148,840223,14636823,645175,28089926
deu_Latn-gle_Latn,771141,12982095,701699,771141,15061046,657163,28043141
heb_Hebr-msa_Latn,1903155,13160335,1282306,1903155,14837671,1356712,27998006
hin_Deva-kan_Knda,1793793,15116266,347019,1793793,12826089,1154768,27942355
ben_Beng-sin_Sinh,1868206,13551948,2428630,1868206,14350689,1510253,27902637
afr_Latn-dan_Latn,1147731,14390267,902799,1147731,13495318,926483,27885585
ara_Arab-mar_Deva,1527971,13967266,1126470,1527971,13911204,1212778,27878470
afr_Latn-sot_Latn,1233284,12390122,759497,1233284,15406100,788061,27796222
ceb_Latn-jav_Latn,1007935,15726415,747128,1007935,12050862,751458,27777277
fas_Arab-lav_Latn,1045121,12805297,772032,1045121,14765625,1137502,27570922
afr_Latn-nya_Latn,1149528,14674994,880366,1149528,12849885,891181,27524879
epo_Latn-slk_Latn,1263250,14393780,944044,1263250,13110271,990736,27504051
hin_Deva-mar_Deva,1953477,13974396,266687,1953477,13464730,965268,27439126
eng_Latn-wol_Latn,1563386,13600133,2896330,1563386,13636959,884692,27237092
eng_Latn-tir_Ethi,1413997,15382137,2798037,1413997,11757592,112950,27139729
ara_Arab-epo_Latn,1226414,12838531,938980,1226414,14224254,944796,27062785
dan_Latn-epo_Latn,1250642,13589736,995405,1250642,13451630,942244,27041366
hau_Latn-zul_Latn,964372,16365103,803714,964372,10635773,767482,27000876
hrv_Latn-zho_Hani,2543253,23802734,2019529,2543253,3144269,4374003,26947003
cat_Latn-lav_Latn,1034778,12344809,796636,1034778,14589723,1124373,26934532
hin_Deva-tam_Taml,1866161,14452057,382742,1866161,12440987,1143476,26893044
bul_Cyrl-epo_Latn,1164473,13368860,960995,1164473,13459520,892400,26828380
ast_Latn-por_Latn,815066,15638024,802568,815066,10763354,702019,26401378
hin_Deva-mal_Mlym,1866005,14308346,336192,1866005,11836883,1320036,26145229
fas_Arab-mal_Mlym,1688629,16395956,1318414,1688629,9658089,1480945,26054045
fas_Arab-ukr_Cyrl,1119748,14476555,837762,1119748,11561781,900667,26038336
epo_Latn-sqi_Latn,973605,12176608,748733,973605,13751785,747012,25928393
hau_Latn-ibo_Latn,713515,13044996,624165,713515,12809337,619992,25854333
epo_Latn-nor_Latn,1219278,12901065,913961,1219278,12908345,956795,25809410
afr_Latn-sna_Latn,1293698,14183390,849608,1293698,11623902,871559,25807292
ast_Latn-cat_Latn,610758,13409289,643466,610758,12346409,600728,25755698
fra_Latn-fil_Latn,1101453,12618161,812250,1101453,13112430,853744,25730591
ell_Grek-tam_Taml,1781554,14432000,1494559,1781554,11200172,1606221,25632172
cat_Latn-est_Latn,1222676,14630858,962572,1222676,10998656,970199,25629514
eng_Latn-srd_Latn,1315908,12375780,2477422,1315908,13181521,864739,25557301
eng_Latn-iku_Cans,1301900,17115280,3159974,1301900,7981568,2545020,25096848
fas_Arab-sin_Sinh,1620117,13555614,1191773,1620117,11455966,1331155,25011580
heb_Hebr-sin_Sinh,1908791,11953614,1458205,1908791,12948729,1634394,24902343
cat_Latn-fas_Arab,1079922,12239507,868046,1079922,12588235,783732,24827742
heb_Hebr-tam_Taml,1872419,13293313,1486907,1872419,11521092,1607668,24814405
deu_Latn-fil_Latn,1108673,11502424,841613,1108673,13248559,852936,24750983
eng_Latn-oci_Latn,1838567,12375534,3336750,1838567,12356952,1106556,24732486
fin_Latn-swa_Latn,1365359,10456760,1091140,1365359,14236193,1060256,24692953
afr_Latn-ara_Arab,758492,13025634,709126,758492,11548919,710848,24574553
hau_Latn-swa_Latn,956009,13612632,733457,956009,10882693,661825,24495325
fas_Arab-hrv_Latn,1175898,13248890,858148,1175898,11033629,935040,24282519
fra_Latn-run_Latn,1261954,13118189,973617,1261954,11042239,916123,24160428
cat_Latn-heb_Hebr,1308659,13630126,985799,1308659,10479898,933062,24110024
deu_Latn-mlg_Latn,946676,11544525,837051,946676,12506886,881413,24051411
hau_Latn-sna_Latn,829672,14052200,696344,829672,9793922,675586,23846122
ceb_Latn-smo_Latn,693375,11202806,530275,693375,12496940,534233,23699746
fra_Latn-tir_Ethi,1100920,13808954,948256,1100920,9776400,95239,23585354
hin_Deva-swa_Latn,985004,12927211,110209,985004,10381336,766041,23308547
fra_Latn-tsn_Latn,1428983,10849675,1062146,1428983,12406014,841372,23255689
eng_Latn-cym_Latn,983047,11416687,1675694,983047,11782484,631569,23199171
ben_Beng-ces_Latn,1370547,11704343,1654886,1370547,11410530,1056711,23114873
afr_Latn-xho_Latn,1361381,12893616,805926,1361381,10214106,815798,23107722
aym_Latn-eng_Latn,1268223,9206251,903130,1268223,13790135,2451735,22996386
guj_Gujr-hin_Deva,1069651,10521318,617891,1069651,12268286,235968,22789604
ceb_Latn-mri_Latn,568191,10695196,461805,568191,11969539,427853,22664735
epo_Latn-srp_Cyrl,1041618,11686743,779206,1041618,10958942,825587,22645685
epo_Latn-slv_Latn,999444,11685564,754541,999444,10949371,780091,22634935
epo_Latn-hun_Latn,1157294,12051040,856497,1157294,10572896,893953,22623936
heb_Hebr-mal_Mlym,1891710,12611901,1508754,1891710,9813162,1647724,22425063
ben_Beng-ron_Latn,1160230,10048763,1403015,1160230,12343095,907251,22391858
hin_Deva-ukr_Cyrl,883513,12796054,108528,883513,9521317,703120,22317371
fin_Latn-tam_Taml,1777321,11433316,1494285,1777321,10874472,1490488,22307788
amh_Ethi-hau_Latn,738789,9101974,226419,738789,13014395,623833,22116369
zho_Hani-ben_Beng,2374742,2541864,3814120,2374742,19446298,3091630,21988162
bul_Cyrl-ben_Beng,1149720,11232403,905581,1149720,10419780,1376789,21652183
ara_Arab-fil_Latn,969720,9902016,690426,969720,11621312,911703,21523328
zho_Hani-bos_Latn,2981338,3033916,3594235,2981338,18394842,2992693,21428758
amh_Ethi-sot_Latn,725948,8377912,209293,725948,12986671,590273,21364583
cat_Latn-epo_Latn,836545,11153632,670814,836545,10204294,645670,21357926
amh_Ethi-zul_Latn,919953,11114562,257943,919953,10097378,767696,21211940
eng_Latn-kur_Latn,1015959,10805253,2014856,1015959,10199029,828334,21004282
eng_Latn-fry_Latn,1347987,10544215,2619670,1347987,10236835,1003106,20781050
eng_Latn-fur_Latn,937010,10221277,1820952,937010,10448778,699141,20670055
cat_Latn-ukr_Cyrl,1077147,11329078,809717,1077147,9308304,791415,20637382
eng_Latn-lij_Latn,1109910,10445636,2182341,1109910,10173699,700125,20619335
eng_Latn-ilo_Latn,1236650,10660419,2394464,1236650,9866168,876801,20526587
epo_Latn-fin_Latn,1130407,11437461,837380,1130407,9016705,901901,20454166
hin_Deva-ori_Orya,1258240,10109135,234420,1258240,10313210,236787,20422345
amh_Ethi-sna_Latn,837868,10224856,201500,837868,10015165,714321,20240021
ben_Beng-snd_Arab,1085469,8990002,1375910,1085469,11136443,683197,20126445
afr_Latn-ibo_Latn,820348,9036210,476805,820348,10836593,574133,19872803
ara_Arab-kur_Latn,805897,9511618,636341,805897,10210803,656591,19722421
amh_Ethi-swa_Latn,1007815,8898827,201531,1007815,10812147,767537,19710974
fra_Latn-tso_Latn,1004486,9348455,743523,1004486,10359940,650326,19708395
grn_Latn-por_Latn,683923,6619858,526593,683923,12840258,683453,19460116
ceb_Latn-sun_Latn,651170,10954009,516687,651170,8418877,524215,19372886
bel_Cyrl-bul_Cyrl,918895,8694847,776281,918895,10499939,801785,19194786
eng_Latn-scn_Latn,1081641,9898804,2259579,1081641,9283464,729197,19182268
ast_Latn-ita_Latn,644311,11871226,623459,644311,7176562,519623,19047788
ben_Beng-slk_Latn,1056235,9474542,1285066,1056235,9352889,802110,18827431
epo_Latn-fas_Arab,846617,8753028,653545,846617,9993733,647359,18746761
amh_Ethi-nya_Latn,710279,9025433,182213,710279,9635158,610398,18660591
guj_Gujr-sin_Sinh,906223,8878708,666625,906223,9664397,750582,18543105
ewe_Latn-fra_Latn,1041977,8924619,562093,1041977,9570458,770928,18495077
afr_Latn-kin_Latn,1041992,9361525,612510,1041992,9123894,612696,18485419
guj_Gujr-snd_Arab,695514,8077783,561236,695514,10326369,561880,18404152
eng_Latn-kas_Arab,647316,7819309,1297459,647316,10420001,148433,18239310
eng_Latn-amh_Ethi,566973,10062408,1131290,566973,8009985,282028,18072393
eng_Latn-lat_Latn,1229624,9796932,2251409,1229624,8200563,753201,17997495
ara_Arab-kat_Geor,757128,8939012,591382,757128,9026766,752198,17965778
heb_Hebr-swa_Latn,977111,7938498,689786,977111,9862018,740080,17800516
deu_Latn-hau_Latn,790275,8347776,549304,790275,9356408,657146,17704184
hau_Latn-som_Latn,530020,8849564,433247,530020,8673688,435073,17523252
fas_Arab-fil_Latn,739941,8723671,529947,739941,8719181,648508,17442852
ben_Beng-zho_Hani,1828686,14934119,2206343,1828686,2391326,3109366,17325445
fra_Latn-sag_Latn,1011399,7580132,791016,1011399,9733671,691889,17313803
fas_Arab-uzb_Latn,580368,14733733,547294,580368,2383554,148817,17117287
ara_Arab-aze_Latn,853544,9325167,543361,853544,7725198,584895,17050365
hau_Latn-xho_Latn,627698,10303106,498250,627698,6743360,478890,17046466
ara_Arab-bel_Cyrl,602673,8564361,548793,602673,8390952,557555,16955313
fra_Latn-tum_Latn,968548,9117893,735423,968548,7788843,697956,16906736
ast_Latn-glg_Latn,425248,9108157,441444,425248,7673075,408081,16781232
ces_Latn-swa_Latn,723271,8017665,560970,723271,8661838,569843,16679503
bel_Cyrl-slk_Latn,867278,7941426,717781,867278,8671778,747777,16613204
ben_Beng-swa_Latn,892584,7932561,1050456,892584,8609316,696664,16541877
bul_Cyrl-swa_Latn,604806,8223644,499615,604806,8094415,493405,16318059
ben_Beng-kor_Hang,940951,8131533,1175173,940951,8043988,686672,16175521
bel_Cyrl-ukr_Cyrl,945517,7984853,771722,945517,8169715,756366,16154568
fra_Latn-kab_Latn,1030601,8761219,923910,1030601,7235581,615746,15996800
ben_Beng-slv_Latn,892114,7941062,1083516,892114,8009017,666101,15950079
deu_Latn-kat_Geor,626490,8507201,617832,626490,7245547,607931,15752748
heb_Hebr-urd_Arab,927679,6280390,589748,927679,9238690,297825,15519080
fra_Latn-orm_Latn,815631,7886359,667323,815631,7609014,710090,15495373
fra_Latn-twi_Latn,934538,8040030,663204,934538,7227153,489218,15267183
heb_Hebr-fil_Latn,779170,6757845,569277,779170,8449795,759799,15207640
ben_Beng-srp_Cyrl,890660,7538793,1093096,890660,7630589,662270,15169382
est_Latn-swa_Latn,800320,6747507,631760,800320,8407125,606253,15154632
bel_Cyrl-hun_Latn,356423,10937904,310028,356423,4049796,498101,14987700
asm_Beng-ben_Beng,1045378,7655742,1279623,1045378,7324451,1255549,14980193
fra_Latn-ful_Latn,700882,7904543,689569,700882,7045445,652649,14949988
fra_Latn-lug_Latn,799623,8169223,585006,799623,6775492,539835,14944715
ara_Arab-hye_Armn,715852,7351251,481308,715852,7475140,318416,14826391
asm_Beng-tel_Telu,955519,8084894,1130725,955519,6690123,856783,14775017
aze_Latn-vie_Latn,701333,5705723,452132,701333,9066648,431698,14772371
hin_Deva-pan_Guru,816564,7279867,141125,816564,7418970,220782,14698837
bjn_Latn-eng_Latn,766935,6795517,872561,766935,7682092,1816388,14477609
eng_Latn-nno_Latn,532455,7473482,939648,532455,7001218,415117,14474700
hin_Deva-msa_Latn,591888,7995890,91084,591888,6380055,456294,14375945
epo_Latn-est_Latn,721470,7783293,544934,721470,6580731,572479,14364024
deu_Latn-sun_Latn,766228,7218878,554037,766228,7100768,654154,14319646
epo_Latn-heb_Hebr,819335,7794024,591821,819335,6503841,596878,14297865
epo_Latn-lav_Latn,580835,6078206,427366,580835,8191750,631146,14269956
aze_Latn-fas_Arab,348969,6371214,378282,348969,7788304,297637,14159518
cat_Latn-hin_Deva,639457,6696568,493544,639457,7428966,77878,14125534
epo_Latn-lit_Latn,757910,7689443,562065,757910,6430118,616137,14119561
zho_Hani-swa_Latn,1237324,1327465,2142041,1237324,12779070,931098,14106535
amh_Ethi-som_Latn,507907,5697298,130073,507907,8403865,416449,14101163
fas_Arab-mar_Deva,857244,7595017,611999,857244,6312188,626459,13907205
deu_Latn-sin_Sinh,674909,6948400,617774,674909,6743596,612355,13691996
eng_Latn-run_Latn,772917,7223502,1482959,772917,6365428,533487,13588930
eng_Latn-hne_Deva,744308,6785482,1380014,744308,6733126,166615,13518608
diq_Latn-eng_Latn,851884,6401126,445956,851884,7106630,1622716,13507756
bel_Cyrl-ron_Latn,330977,8636924,282593,330977,4829952,370038,13466876
heb_Hebr-mar_Deva,966717,6406943,730917,966717,6989572,745390,13396515
ceb_Latn-ilo_Latn,610331,6816751,374907,610331,6431539,378912,13248290
eng_Latn-tso_Latn,688317,6109671,1303603,688317,7052410,422494,13162081
epo_Latn-ukr_Cyrl,741768,6944050,533377,741768,6213696,550188,13157746
spa_Latn-oci_Latn,925383,6449694,588224,925383,6395618,557542,12845312
asm_Beng-mal_Mlym,877678,7321046,1047388,877678,5481364,746798,12802410
fra_Latn-nso_Latn,768309,6054559,575818,768309,6668635,493603,12723194
bel_Cyrl-ita_Latn,387883,8107833,315693,387883,4541701,303685,12649534
ben_Beng-lav_Latn,567673,4658834,685733,567673,7963000,618552,12621834
eng_Latn-kur_Arab,339369,6102580,712514,339369,6504575,303997,12607155
amh_Ethi-ibo_Latn,410206,5130862,122398,410206,7364976,343719,12495838
crh_Latn-rus_Cyrl,653348,5711003,541366,653348,6756525,601193,12467528
epo_Latn-mkd_Cyrl,480867,6108103,380947,480867,6271478,394441,12379581
nep_Deva-rus_Cyrl,556915,6157329,147020,556915,5884932,429905,12042261
asm_Beng-kan_Knda,784483,6668507,923836,784483,5275132,636774,11943639
fra_Latn-lin_Latn,691379,6074542,521710,691379,5866161,471402,11940703
ben_Beng-est_Latn,742243,6205722,888396,742243,5644388,590101,11850110
aze_Latn-deu_Latn,495671,5582919,402924,495671,6217225,418921,11800144
fon_Latn-fra_Latn,508215,6119999,366672,508215,5625869,431097,11745868
eng_Latn-bre_Latn,563720,5137407,986959,563720,6559368,404188,11696775
ceb_Latn-war_Latn,710001,5759384,320822,710001,5890491,313953,11649875
asm_Beng-urd_Arab,573821,4821623,702992,573821,6752817,108167,11574440
eng_Latn-ceb_Latn,488758,5273684,826013,488758,6227860,316005,11501544
eng_Latn-tum_Latn,651395,6120467,1257988,651395,5373290,458792,11493757
deu_Latn-mar_Deva,442634,5932805,383520,442634,5547293,402954,11480098
ewe_Latn-swa_Latn,515586,6291439,322041,515586,5136849,343503,11428288
amh_Ethi-yor_Latn,415958,4520931,112066,415958,6857745,326881,11378676
nep_Deva-vie_Latn,307685,4681894,113146,307685,6625104,270511,11306998
deu_Latn-tel_Telu,421353,6102050,408915,421353,5147316,402986,11249366
deu_Latn-hye_Armn,387446,5762537,390024,387446,5444529,240648,11207066
fra_Latn-luo_Latn,609597,5863289,477177,609597,5279835,466754,11143124
bel_Cyrl-slv_Latn,601453,5256720,482659,601453,5878265,480225,11134985
nep_Deva-por_Latn,426419,5219447,142448,426419,5914861,335681,11134308
zho_Hani-mal_Mlym,1592305,1704182,2602763,1592305,9357281,1333994,11061463
asm_Beng-guj_Gujr,594345,5955076,726976,594345,5086915,459060,11041991
aze_Latn-urd_Arab,248055,4815979,278719,248055,6129316,127592,10945295
eng_Latn-shn_Mymr,646766,6110224,1296027,646766,4787417,37294,10897641
amh_Ethi-xho_Latn,507839,5672576,155664,507839,5223480,396320,10896056
spa_Latn-nep_Deva,394970,5834589,304108,394970,4974038,135241,10808627
ces_Latn-tam_Taml,703180,6004015,528735,703180,4786202,529290,10790217
fra_Latn-nep_Deva,390832,5797542,308851,390832,4889013,130621,10686555
ara_Arab-tel_Telu,412259,5536123,381976,412259,5074826,381735,10610949
afr_Latn-tsn_Latn,779109,4660188,310354,779109,5908529,314419,10568717
zho_Hani-tam_Taml,1307759,1485658,2210427,1307759,9020005,909108,10505663
hin_Deva-mlg_Latn,407975,5743953,44478,407975,4719141,355919,10463094
asm_Beng-ori_Orya,601125,5248177,697148,601125,5187842,55016,10436019
ben_Beng-cat_Latn,592282,4684962,716442,592282,5543722,448828,10228684
asm_Beng-tam_Taml,709912,5698409,862911,709912,4486286,571450,10184695
aze_Latn-fra_Latn,433161,4426344,339724,433161,5675708,339434,10102052
hin_Deva-sin_Sinh,714711,4969976,122494,714711,5127932,487512,10097908
ita_Latn-nep_Deva,400305,5301906,280631,400305,4785142,129051,10087048
ceb_Latn-fij_Latn,349228,4569013,228474,349228,5405888,227935,9974901
afr_Latn-tso_Latn,554436,4575883,262255,554436,5376807,256881,9952690
epo_Latn-hrv_Latn,537448,5158659,388580,537448,4766155,428827,9924814
ben_Beng-epo_Latn,517482,4795341,631004,517482,5110275,390773,9905616
aze_Latn-spa_Latn,441813,4380771,340559,441813,5486961,347343,9867732
nep_Deva-nld_Latn,414256,4760043,126150,414256,5094353,313814,9854396
deu_Latn-nep_Deva,391863,4929576,312432,391863,4861093,132785,9790669
aze_Latn-nld_Latn,383673,4532016,323044,383673,5236115,325284,9768131
zho_Hani-sqi_Latn,1064345,1076147,1336164,1064345,8611186,1045814,9687333
aze_Latn-por_Latn,416714,4321591,330112,416714,5279179,333178,9600770
deu_Latn-hat_Latn,297388,4407341,289783,297388,5176335,278627,9583676
ben_Beng-mai_Deva,747288,4380875,918923,747288,5198837,121757,9579712
deu_Latn-yor_Latn,432122,4347221,319633,432122,5100085,358869,9447306
deu_Latn-fry_Latn,616955,4663506,489769,616955,4703987,486370,9367493
ara_Arab-hat_Latn,292352,4354935,262406,292352,4995939,268197,9350874
heb_Hebr-mlg_Latn,476278,4018869,365598,476278,5316419,404820,9335288
afr_Latn-ewe_Latn,603697,4624282,283450,603697,4663586,240121,9287868
bod_Tibt-eng_Latn,714557,3346292,97349,714557,5928673,1375610,9274965
zho_Hani-tgl_Latn,864965,985957,1219163,864965,8193137,490241,9179094
ara_Arab-crh_Latn,458493,5267337,343142,458493,3874920,363526,9142257
asm_Beng-mar_Deva,597203,4654115,712972,597203,4444098,450889,9098213
ara_Arab-kaz_Cyrl,509393,4839011,317393,509393,4215275,332111,9054286
bel_Cyrl-srp_Cyrl,549530,4344052,433044,549530,4685506,436853,9029558
ben_Beng-mkd_Cyrl,491186,4264032,590180,491186,4758406,367214,9022438
fas_Arab-snd_Arab,271768,4434271,204447,271768,4521615,255006,8955886
ben_Beng-mlg_Latn,380762,4122837,446804,380762,4790617,347352,8913454
nep_Deva-pol_Latn,342544,4539774,127444,342544,4334286,288714,8874060
ben_Beng-ukr_Cyrl,592521,4473928,721972,592521,4376945,425944,8850873
ast_Latn-ron_Latn,298836,5432879,294070,298836,3303229,251534,8736108
cat_Latn-swa_Latn,327874,4575525,259853,327874,4146654,256888,8722179
aze_Latn-ita_Latn,376555,3954124,295688,376555,4766174,297565,8720298
bul_Cyrl-nep_Deva,316300,4457958,268034,316300,4256014,121070,8713972
bul_Cyrl-tam_Taml,586304,4968895,453565,586304,3744954,436002,8713849
deu_Latn-eus_Latn,695558,4752410,587900,695558,3961263,609240,8713673
hrv_Latn-tam_Taml,595735,4932177,473718,595735,3737525,466604,8669702
ful_Latn-yor_Latn,374851,3863872,294106,374851,4784421,320099,8648293
nep_Deva-swe_Latn,313165,4295201,116329,313165,4349363,276974,8644564
nep_Deva-ron_Latn,297371,4072557,118133,297371,4546796,264618,8619353
bel_Cyrl-nld_Latn,288115,5364587,230096,288115,3251375,199293,8615962
afr_Latn-tir_Ethi,454265,4886402,319071,454265,3675037,38948,8561439
aze_Latn-ron_Latn,326027,3860659,280740,326027,4680550,284161,8541209
amh_Ethi-ful_Latn,405074,3391936,66748,405074,5093937,346925,8485873
asm_Beng-nep_Deva,569121,4179808,717001,569121,4270883,57603,8450691
epo_Latn-swa_Latn,292730,4173339,241645,292730,4243831,244089,8417170
aze_Latn-ces_Latn,317661,4085170,289793,317661,4284005,279872,8369175
aze_Latn-hin_Deva,251274,3536016,228961,251274,4819409,101014,8355425
ces_Latn-nep_Deva,307608,4050002,273224,307608,4255747,118019,8305749
afr_Latn-isl_Latn,346081,4307654,272028,346081,3996958,282896,8304612
dan_Latn-nep_Deva,293819,4166811,257698,293819,4125436,114045,8292247
ceb_Latn-deu_Latn,477031,4212387,396276,477031,4076387,318625,8288774
afr_Latn-run_Latn,538782,4257166,272816,538782,4022829,278870,8279995
fra_Latn-kon_Latn,500194,3858603,367872,500194,4410554,299201,8269157
nep_Deva-slv_Latn,300669,4115156,112218,300669,4045713,255843,8160869
ben_Beng-msa_Latn,482810,3964949,594280,482810,4173033,350405,8137982
guj_Gujr-mai_Deva,432850,3382656,283330,432850,4754518,75075,8137174
hrv_Latn-nep_Deva,302267,3970085,258257,302267,4132997,116399,8103082
nep_Deva-sqi_Latn,235659,3714047,106566,235659,4352056,224751,8066103
awa_Deva-guj_Gujr,253396,4915017,31075,253396,3149495,215262,8064512
hun_Latn-nep_Deva,304517,3884675,263964,304517,4175482,117866,8060157
bak_Cyrl-tat_Cyrl,456954,4112321,329148,456954,3889895,317439,8002216
zho_Hani-tha_Thai,1664731,1862629,1954110,1664731,6139022,410078,8001651
aze_Latn-pol_Latn,343465,3882306,277200,343465,4098626,278488,7980932
aze_Latn-bul_Cyrl,309181,3722341,263455,309181,4256574,269779,7978915
ewe_Latn-zul_Latn,344409,4881875,237042,344409,3043284,244906,7925159
eng_Latn-mni_Beng,490086,4209029,971669,490086,3715632,594752,7924661
nep_Deva-slk_Latn,280835,4000680,112799,280835,3850315,252791,7850995
lit_Latn-nep_Deva,282901,3619693,259698,282901,4107447,123283,7727140
aze_Latn-swe_Latn,284402,3614373,257600,284402,4086000,254661,7700373
cym_Latn-deu_Latn,354033,4063444,236865,354033,3615612,247308,7679056
aze_Latn-sqi_Latn,243408,3419959,213928,243408,4229982,198087,7649941
nep_Deva-nor_Latn,232646,3766966,99677,232646,3882792,230029,7649758
afr_Latn-nep_Deva,236497,3992916,216964,236497,3625450,100112,7618366
fij_Latn-mlg_Latn,298775,4405423,187858,298775,3175770,180097,7581193
deu_Latn-jav_Latn,823160,4542532,281093,823160,2991191,295909,7533723
ara_Arab-mlg_Latn,230706,3534623,222865,230706,3990738,226927,7525361
dan_Latn-tam_Taml,519138,4338847,382379,519138,3169189,377708,7508036
fra_Latn-kik_Latn,455327,3936950,368978,455327,3568515,288114,7505465
zho_Hani-mlg_Latn,545219,573483,874312,545219,6888941,858543,7462424
ewe_Latn-nya_Latn,285074,4177898,205085,285074,3254849,219221,7432747
fin_Latn-nep_Deva,298201,3328154,259129,298201,4073002,112219,7401156
hin_Deva-snd_Arab,476004,3365820,82041,476004,4023676,243000,7389496
deu_Latn-kaz_Cyrl,347842,3967743,285798,347842,3414617,274710,7382360
bel_Cyrl-swe_Latn,260550,4784045,205438,260550,2581128,169673,7365173
cat_Latn-nep_Deva,252491,4004295,233545,252491,3337178,112852,7341473
afr_Latn-twi_Latn,567497,3679368,217418,567497,3639486,189907,7318854
ara_Arab-cym_Latn,322405,3533317,211210,322405,3765281,216897,7298598
ful_Latn-swa_Latn,323956,3514657,268696,323956,3764546,273848,7279203
bho_Deva-tel_Telu,456504,4458762,114356,456504,2802447,411939,7261209
ara_Arab-diq_Latn,414649,3675231,237591,414649,3542235,226549,7217466
nep_Deva-ukr_Cyrl,288539,3639680,116528,288539,3508831,241904,7148511
isl_Latn-nep_Deva,234462,3581127,225958,234462,3546919,103892,7128046
dyu_Latn-fra_Latn,368809,3824036,268849,368809,3266771,291273,7090807
afr_Latn-lug_Latn,476946,3529201,204971,476946,3523584,238519,7052785
fra_Latn-wol_Latn,381202,3628349,252501,381202,3415395,226130,7043744
nep_Deva-tgl_Latn,188333,3113871,83508,188333,3903009,183442,7016880
zho_Hani-isl_Latn,778542,882651,943508,778542,6128787,689553,7011438
ben_Beng-bho_Deva,471967,2970488,565143,471967,3934651,93783,6905139
ewe_Latn-tso_Latn,237265,3340524,155202,237265,3561035,156429,6901559
awa_Deva-tel_Telu,412312,4293318,103547,412312,2578782,404430,6872100
nep_Deva-srp_Cyrl,207215,3493098,100261,207215,3375726,214156,6868824
aze_Latn-nor_Latn,253861,3259618,234663,253861,3609042,237414,6868660
aze_Latn-hun_Latn,306975,3351337,271758,306975,3489986,282187,6841323
hau_Latn-kin_Latn,340162,3932514,221653,340162,2908139,189401,6840653
nep_Deva-sin_Sinh,232772,3408472,133683,232772,3418268,228978,6826740
ban_Latn-eng_Latn,325020,3412733,323792,325020,3399394,690904,6812127
hin_Deva-mai_Deva,550238,3181851,64250,550238,3609611,79110,6791462
mar_Deva-nep_Deva,226595,3316349,245424,226595,3461241,101706,6777590
asm_Beng-hin_Deva,495686,3462720,651797,495686,3309873,88734,6772593
gle_Latn-nld_Latn,242798,4710857,24836,242798,2021113,133672,6731970
zho_Hani-cat_Latn,539452,728953,710365,539452,5951845,403252,6680798
ewe_Latn-sna_Latn,281234,3958887,190559,281234,2717553,203178,6676440
afr_Latn-orm_Latn,471648,3064189,251482,471648,3607502,310711,6671691
ful_Latn-som_Latn,240524,2632153,196970,240524,3974501,229608,6606654
bam_Latn-fra_Latn,311728,3530937,266394,311728,3063729,257157,6594666
ara_Arab-mya_Mymr,318525,3667688,249368,318525,2920164,170354,6587852
lav_Latn-nep_Deva,252492,3152694,220142,252492,3428214,110223,6580908
aze_Latn-hrv_Latn,279213,3140824,229699,279213,3420965,237753,6561789
aze_Latn-ukr_Cyrl,278570,3159073,237528,278570,3395755,241621,6554828
deu_Latn-glg_Latn,339217,3160942,289068,339217,3390228,273548,6551170
est_Latn-nep_Deva,260156,3008389,224568,260156,3534066,114436,6542455
aze_Latn-dan_Latn,249792,3057333,224611,249792,3482487,232344,6539820
ful_Latn-hau_Latn,269324,2822210,203117,269324,3708885,227483,6531095
awa_Deva-tam_Taml,388695,4134905,111560,388695,2329811,332110,6464716
amh_Ethi-deu_Latn,220439,2968987,134987,220439,3479413,202261,6448400
nep_Deva-urd_Arab,186499,2757511,97418,186499,3630377,161166,6387888
amh_Ethi-ara_Arab,235426,3042178,155818,235426,3325133,215556,6367311
ceb_Latn-ind_Latn,271058,3102834,241497,271058,3196873,215837,6299707
msa_Latn-nep_Deva,269808,3165957,193220,269808,3133699,102987,6299656
bho_Deva-guj_Gujr,324107,3745012,90681,324107,2504459,230983,6249471
mkd_Cyrl-nep_Deva,212496,3244320,193177,212496,2975892,107247,6220212
ara_Arab-ful_Latn,346129,2914266,245268,346129,3256316,292874,6170582
aym_Latn-spa_Latn,351564,2445682,238885,351564,3724606,282463,6170288
afr_Latn-tum_Latn,407213,3169143,183259,407213,2987960,208369,6157103
ben_Beng-mag_Deva,444693,2639796,542103,444693,3500210,56693,6140006
dyu_Latn-eng_Latn,286390,3317337,208079,286390,2777852,564839,6095189
urd_Arab-zho_Hani,310467,5723308,91484,310467,355108,498375,6078416
aze_Latn-ben_Beng,202640,2857525,192558,202640,3215113,325558,6072638
hin_Deva-pus_Arab,285383,2613653,46779,285383,3421179,164429,6034832
nep_Deva-tel_Telu,196101,3251310,104774,196101,2772114,202268,6023424
deu_Latn-ilo_Latn,402764,3106679,263307,402764,2902832,310993,6009511
aze_Latn-lit_Latn,224370,2915298,208413,224370,2987793,214692,5903091
cat_Latn-tam_Taml,425962,3417188,336851,425962,2442149,317786,5859337
aze_Latn-msa_Latn,184018,2680043,173412,184018,3133019,172425,5813062
awa_Deva-ben_Beng,376381,3401410,66392,376381,2409245,456971,5810655
mal_Mlym-nep_Deva,204114,2535255,207463,204114,3226052,104404,5761307
ara_Arab-mon_Cyrl,251510,2915765,184668,251510,2832335,197098,5748100
amh_Ethi-tso_Latn,243240,2139053,22240,243240,3583784,170996,5722837
ceb_Latn-pag_Latn,269382,2904069,152951,269382,2817438,155483,5721507
aze_Latn-lav_Latn,216560,2803976,194611,216560,2917126,200787,5721102
deu_Latn-kur_Arab,171009,2739464,175105,171009,2967602,146293,5707066
aze_Latn-cat_Latn,205031,2471969,182407,205031,3222865,184183,5694834
aze_Latn-slk_Latn,209343,2725514,192050,209343,2954706,196945,5680220
aze_Latn-fin_Latn,265062,2954769,235763,265062,2712355,240069,5667124
aze_Latn-est_Latn,222968,2859432,207770,222968,2751754,212566,5611186
aze_Latn-slv_Latn,198987,2671354,186183,198987,2938818,190551,5610172
bel_Cyrl-ell_Grek,203724,3505684,159573,203724,2097091,165842,5602775
amh_Ethi-tir_Ethi,290074,2657321,32304,290074,2916793,20152,5574114
fon_Latn-swa_Latn,260336,3414252,170221,260336,2140803,158825,5555055
fra_Latn-kmb_Latn,313818,2658090,231797,313818,2896346,206886,5554436
hau_Latn-tso_Latn,249890,2767747,146184,249890,2773421,122962,5541168
ben_Beng-san_Deva,459675,2929048,551726,459675,2597802,52176,5526850
ara_Arab-snd_Arab,168923,2719495,137637,168923,2801600,156747,5521095
ell_Grek-nep_Deva,221356,2848578,162670,221356,2661621,75316,5510199
deu_Latn-som_Latn,193282,2805850,155339,193282,2701531,145258,5507381
deu_Latn-tgk_Cyrl,246900,2778229,194430,246900,2725447,182338,5503676
fij_Latn-smo_Latn,183463,2658798,107898,183463,2827753,109134,5486551
bel_Cyrl-dan_Latn,201499,3357427,158962,201499,2118834,168763,5476261
amh_Ethi-ewe_Latn,237369,2134108,22976,237369,3291526,160530,5425634
deu_Latn-mon_Cyrl,245642,2737861,189157,245642,2666170,185977,5404031
afr_Latn-nso_Latn,408513,2426913,165960,408513,2963666,162403,5390579
afr_Latn-aze_Latn,170063,2953163,174108,170063,2433907,171086,5387070
hau_Latn-tsn_Latn,294957,2588479,156531,294957,2763458,131543,5351937
bho_Deva-mal_Mlym,358551,3355553,88372,358551,1976810,303198,5332363
aze_Latn-srp_Cyrl,175485,2509984,183385,175485,2793144,187494,5303128
awa_Deva-mal_Mlym,327327,3431005,76474,327327,1870807,304007,5301812
amh_Ethi-kin_Latn,295671,2389594,39976,295671,2901858,219585,5291452
hau_Latn-tum_Latn,260574,2995626,164408,260574,2293400,159162,5289026
aze_Latn-mkd_Cyrl,179909,2391478,167884,179909,2891067,169168,5282545
guj_Gujr-mag_Deva,289857,2074979,192274,289857,3204244,62665,5279223
ful_Latn-kin_Latn,219989,2608762,187460,219989,2655992,186941,5264754
bel_Cyrl-nep_Deva,188042,2594630,179936,188042,2669712,102438,5264342
aka_Latn-fra_Latn,309458,2880100,202758,309458,2384048,231796,5264148
bho_Deva-tam_Taml,361090,3272346,96706,361090,1984213,287044,5256559
aze_Latn-kat_Geor,188995,2464581,186077,188995,2758460,207106,5223041
ewe_Latn-xho_Latn,237280,3181814,154698,237280,2038946,160703,5220760
afr_Latn-fon_Latn,250233,2507647,163436,250233,2693327,161198,5200974
ara_Arab-wol_Latn,319786,2369338,158398,319786,2820506,173531,5189844
zho_Hani-ltz_Latn,533170,569833,891447,533170,4611177,420212,5181010
ewe_Latn-twi_Latn,215111,2659856,125131,215111,2503273,130376,5163129
asm_Beng-pan_Guru,275182,2512899,349220,275182,2635049,58612,5147948
asm_Beng-sin_Sinh,329991,2550202,410821,329991,2596781,278064,5146983
ful_Latn-nya_Latn,220799,2625961,191443,220799,2515477,194704,5141438
ara_Arab-glg_Latn,272499,2383502,158696,272499,2757295,217853,5140797
hau_Latn-run_Latn,261411,2972676,160462,261411,2158291,138204,5130967
nep_Deva-swa_Latn,141172,2488888,87549,141172,2630415,158881,5119303
ewe_Latn-tsn_Latn,227491,2371233,114154,227491,2744195,120461,5115428
bho_Deva-hin_Deva,356232,2843190,75844,356232,2260581,56105,5103771
fij_Latn-ilo_Latn,206477,2850714,124372,206477,2244991,127085,5095705
ara_Arab-khm_Khmr,352535,3052639,200419,352535,2032997,148358,5085636
hau_Latn-nld_Latn,232833,2653815,192396,232833,2430799,161380,5084614
ara_Arab-sun_Latn,173741,2543231,152204,173741,2522695,152888,5065926
amh_Ethi-tsn_Latn,267801,1821573,38249,267801,3234877,155562,5056450
bel_Cyrl-lit_Latn,178849,3334472,142061,178849,1703943,161176,5038415
afr_Latn-lin_Latn,346066,2409622,158328,346066,2604263,159520,5013885
ara_Arab-tgk_Cyrl,221383,2539467,157637,221383,2471999,158771,5011466
aze_Latn-hye_Armn,225726,2394165,185278,225726,2614389,128611,5008554
fra_Latn-ssw_Latn,348692,2977443,251626,348692,1999530,222521,4976973
crh_Latn-tat_Cyrl,501671,2517063,91531,501671,2453499,442468,4970562
bho_Deva-urd_Arab,245579,2380721,39113,245579,2587503,37469,4968224
awa_Deva-urd_Arab,227207,2436513,29116,227207,2517357,31525,4953870
amh_Ethi-run_Latn,251753,2221291,26004,251753,2650969,191367,4872260
amh_Ethi-tum_Latn,248037,2175629,27229,248037,2688558,186245,4864187
ewe_Latn-run_Latn,197221,2750835,134767,197221,2091314,140022,4842149
est_Latn-tam_Taml,378368,2620978,299453,378368,2201197,290536,4822175
eng_Latn-ber_Latn,185825,2307869,380557,185825,2503982,161176,4811851
ewe_Latn-hau_Latn,204798,2318243,112782,204798,2467916,132077,4786159
nep_Deva-tam_Taml,219296,2545826,102070,219296,2222033,180365,4767859
eng_Latn-uzb_Cyrl,193657,2580479,341920,193657,2183187,204068,4763666
ewe_Latn-kin_Latn,210280,2669794,133521,210280,2088891,141741,4758685
afr_Latn-luo_Latn,309255,2358513,157079,309255,2387725,175383,4746238
awa_Deva-nep_Deva,239123,2688318,40712,239123,2031594,21567,4719912
kat_Geor-nep_Deva,147047,2201670,175981,147047,2505060,100211,4706730
hin_Deva-mag_Deva,327968,2031172,44522,327968,2672985,59993,4704157
deu_Latn-nob_Latn,215470,2301925,159884,215470,2374996,150843,4676921
fij_Latn-jav_Latn,224840,2754378,147204,224840,1873796,146132,4628174
ara_Arab-uzb_Cyrl,162301,2362432,122550,162301,2244985,121006,4607417
aze_Latn-tgl_Latn,172638,1958874,140836,172638,2626484,143536,4585358
kor_Hang-nep_Deva,204574,2081994,137209,204574,2484149,72384,4566143
bho_Deva-kan_Knda,286621,2835113,64910,286621,1717964,228780,4553077
hau_Latn-twi_Latn,212470,2378539,129061,212470,2138392,115175,4516931
ewe_Latn-sot_Latn,188815,2117106,105450,188815,2385051,115520,4502157
fij_Latn-hin_Deva,277619,2686034,132340,277619,1806514,39109,4492548
aze_Latn-swa_Latn,154039,2123697,140778,154039,2329665,144140,4453362
amh_Ethi-twi_Latn,217554,1821378,23993,217554,2624552,147147,4445930
dyu_Latn-swa_Latn,242727,2628022,146382,242727,1812383,144478,4440405
bel_Cyrl-lav_Latn,134527,2497680,106301,134527,1896799,149186,4394479
aze_Latn-bel_Cyrl,152029,2079479,145448,152029,2257872,148812,4337351
mlg_Latn-nep_Deva,122918,2252707,140262,122918,2049080,81198,4301787
bel_Cyrl-est_Latn,160030,2815591,129562,160030,1458995,122971,4274586
eng_Latn-div_Thaa,99827,2192515,217794,99827,2070048,202533,4262563
deu_Latn-nds_Latn,213324,2068830,157065,213324,2186718,151604,4255548
deu_Latn-mya_Mymr,202558,2622395,173953,202558,1624978,78567,4247373
fij_Latn-mri_Latn,119675,2114399,78862,119675,2123330,75462,4237729
awa_Deva-kan_Knda,250180,2722520,59710,250180,1513784,214286,4236304
aze_Latn-kor_Hang,176882,2168638,161517,176882,2054888,154630,4223526
bho_Deva-nep_Deva,248341,2344206,47562,248341,1863962,22358,4208168
ewe_Latn-yor_Latn,166903,1949140,91600,166903,2185904,111879,4135044
bak_Cyrl-kir_Cyrl,227633,2215927,176122,227633,1910288,168674,4126215
guj_Gujr-san_Deva,276682,2165734,172997,276682,1956788,40311,4122522
ewe_Latn-tum_Latn,178376,2311610,112393,178376,1803703,121171,4115313
aze_Latn-ell_Grek,172897,1868243,142952,172897,2194185,144581,4062428
bho_Deva-mar_Deva,253778,2304068,55532,253778,1736699,182704,4040767
aze_Latn-isl_Latn,135063,1895437,132058,135063,2137068,135271,4032505
hye_Armn-nep_Deva,118478,1985132,100793,118478,2040476,76344,4025608
aze_Latn-mal_Mlym,114677,1798617,117438,114677,2200120,138022,3998737
dan_Latn-ltz_Latn,249632,2009502,200822,249632,1988695,211370,3998197
bel_Cyrl-fin_Latn,170432,2628103,131642,170432,1364104,120645,3992207
fij_Latn-war_Latn,183377,2137337,92803,183377,1844943,90383,3982280
ewe_Latn-som_Latn,174249,1917507,93703,174249,2053736,115840,3971243
eng_Latn-ssw_Latn,260205,2291821,478760,260205,1659753,165199,3951574
deu_Latn-mri_Latn,99585,1682621,93239,99585,2250042,66612,3932663
hau_Latn-luo_Latn,163053,2093803,106004,163053,1785954,97196,3879757
amh_Ethi-nep_Deva,130863,1777631,97667,130863,2083876,64858,3861507
ful_Latn-zul_Latn,197497,2133283,160329,197497,1722292,162696,3855575
bam_Latn-eng_Latn,180914,2109423,150500,180914,1729629,360834,3839052
ara_Arab-hau_Latn,126532,1884431,99175,126532,1940060,100163,3824491
ewe_Latn-tir_Ethi,153105,2215325,105814,153105,1579120,5304,3794445
nep_Deva-tha_Thai,209689,2041545,69381,209689,1749331,73878,3790876
nep_Deva-sun_Latn,90773,1872009,62035,90773,1860018,119500,3732027
ara_Arab-pus_Arab,162645,1695010,110556,162645,2028666,111450,3723676
bel_Cyrl-nor_Latn,178754,2117471,136111,178754,1595797,135214,3713268
bel_Cyrl-vie_Latn,168573,1928863,111254,168573,1734804,88995,3663667
eng_Latn-nds_Latn,249147,1823791,388900,249147,1819610,138449,3643401
awa_Deva-sin_Sinh,177406,2090919,43694,177406,1550983,166689,3641902
hin_Deva-san_Deva,322648,1858345,49467,322648,1770429,58211,3628774
hau_Latn-tir_Ethi,170377,2177602,120479,170377,1422821,10761,3600423
fon_Latn-nya_Latn,131145,2204307,90407,131145,1385589,91805,3589896
awa_Deva-pan_Guru,122742,2152254,10279,122742,1432957,36350,3585211
aze_Latn-tat_Cyrl,191898,1743243,136068,191898,1834472,138054,3577715
ace_Latn-ceb_Latn,144855,1756116,96043,144855,1796120,94952,3552236
aze_Latn-kaz_Cyrl,180729,1795606,142060,180729,1753022,140179,3548628
eng_Latn-kmb_Latn,196232,1672284,377905,196232,1856509,128857,3528793
deu_Latn-xho_Latn,159010,1967613,114669,159010,1558925,111570,3526538
aze_Latn-tam_Taml,122923,1659943,126987,122923,1862292,128117,3522235
ara_Arab-mri_Latn,96629,1370051,99317,96629,2151665,65773,3521716
cat_Latn-oci_Latn,191689,1773063,125614,191689,1744335,122448,3517398
hin_Deva-fil_Latn,136819,1767059,28029,136819,1741028,104685,3508087
hau_Latn-lin_Latn,172564,1860070,101682,172564,1622857,85991,3482927
afr_Latn-wol_Latn,237020,1630824,94770,237020,1805511,100092,3436335
ceb_Latn-vie_Latn,62225,1725717,54123,62225,1709265,56789,3434982
kaz_Cyrl-nep_Deva,148246,1597425,126713,148246,1818869,71933,3416294
hau_Latn-nso_Latn,181263,1701140,99987,181263,1707612,79768,3408752
ara_Arab-nob_Latn,183076,1563119,77851,183076,1834903,124855,3398022
ewe_Latn-lin_Latn,137139,1759090,85124,137139,1633307,87895,3392397
ara_Arab-kir_Cyrl,155759,1741640,116732,155759,1644323,119130,3385963
deu_Latn-yid_Hebr,144941,2340912,121941,144941,1034306,158527,3375218
awa_Deva-hin_Deva,204733,1971318,28223,204733,1401240,31415,3372558
hau_Latn-lug_Latn,182946,1903511,105104,182946,1458752,95744,3362263
mri_Latn-nep_Deva,75866,1931211,54107,75866,1414870,31333,3346081
asm_Beng-snd_Arab,191191,1509529,235480,191191,1833835,128375,3343364
ful_Latn-xho_Latn,167056,1853032,135326,167056,1484783,134741,3337815
eng_Latn-kek_Latn,60992,1533159,128056,60992,1787398,132710,3320557
deu_Latn-pus_Arab,135326,1479620,106252,135326,1840480,102280,3320100
bak_Cyrl-uzb_Latn,195675,1740034,153322,195675,1575417,146944,3315451
eng_Latn-min_Latn,302082,1786940,595714,302082,1512868,194820,3299808
deu_Latn-kir_Cyrl,136559,1682749,117822,136559,1583623,117483,3266372
deu_Latn-khm_Khmr,233039,1928310,158357,233039,1312424,96662,3240734
aze_Latn-tha_Thai,205835,1853382,150693,205835,1370234,100983,3223616
fon_Latn-zul_Latn,137770,2129510,93017,137770,1075542,88554,3205052
bho_Deva-ori_Orya,179348,1808535,42439,179348,1383270,15223,3191805
ewe_Latn-luo_Latn,117701,1667847,75213,117701,1513493,80328,3181340
amh_Ethi-lug_Latn,173692,1417672,21828,173692,1761874,110564,3179546
nep_Deva-som_Latn,83148,1533238,35247,83148,1595866,83869,3129104
awa_Deva-mar_Deva,182453,1827883,33185,182453,1295417,135772,3123300
fij_Latn-sun_Latn,145977,1893819,101236,145977,1222342,101823,3116161
zho_Hani-eus_Latn,458727,527217,566056,458727,2585361,421768,3112578
ara_Arab-yor_Latn,86108,1412658,95744,86108,1693513,95944,3106171
hat_Latn-nep_Deva,81219,1654137,94513,81219,1424428,54709,3078565
eng_Latn-pck_Latn,61493,1541743,128952,61493,1511856,57367,3053599
amh_Ethi-luo_Latn,137990,1254538,15302,137990,1797962,103411,3052500
dyu_Latn-hau_Latn,130397,1544654,72432,130397,1498592,79694,3043246
nep_Deva-xho_Latn,135796,1700317,37494,135796,1333334,94441,3033651
zho_Hani-sin_Sinh,385900,426935,466212,385900,2591588,321379,3018523
aze_Latn-heb_Hebr,168840,1488580,123206,168840,1528342,121265,3016922
fij_Latn-pag_Latn,134406,1666732,76357,134406,1345495,75820,3012227
bho_Deva-pan_Guru,148821,1655760,41207,148821,1352020,30793,3007780
amh_Ethi-lin_Latn,150344,1206234,16607,150344,1771014,102278,2977248
zho_Hani-afr_Latn,222351,289641,254861,222351,2666531,125706,2956172
ewe_Latn-lug_Latn,139011,1644290,75416,139011,1309157,80225,2953447
eng_Latn-plt_Latn,61145,1531531,128264,61145,1406216,57601,2937747
ban_Latn-ceb_Latn,105963,1469246,76625,105963,1456704,70655,2925950
cym_Latn-nld_Latn,178800,1452939,130684,178800,1472058,116571,2924997
ewe_Latn-ibo_Latn,117599,1346328,62585,117599,1566026,74274,2912354
fon_Latn-tso_Latn,97368,1562912,60765,97368,1339490,58742,2902402
fon_Latn-som_Latn,108277,1600192,68283,108277,1301211,73082,2901403
dyu_Latn-som_Latn,112843,1451961,66603,112843,1396537,75212,2848498
deu_Latn-sna_Latn,78315,1601431,89009,78315,1236389,88943,2837820
afr_Latn-kon_Latn,199757,1273284,71227,199757,1562542,74576,2835826
cym_Latn-nep_Deva,145551,1465922,88656,145551,1368677,52132,2834599
bho_Deva-sin_Sinh,169395,1568056,35971,169395,1246083,143014,2814139
ace_Latn-mlg_Latn,123583,1470943,82040,123583,1338003,77308,2808946
nep_Deva-tgk_Cyrl,133870,1388695,62584,133870,1418597,98640,2807292
ceb_Latn-tgl_Latn,70944,1418622,58157,70944,1371182,55827,2789804
ben_Beng-fil_Latn,128684,1231529,177365,128684,1544474,96134,2776003
afr_Latn-ful_Latn,168971,1346827,100530,168971,1415972,106998,2762799
aze_Latn-tel_Telu,106811,1372423,103441,106811,1389424,104192,2761847
fon_Latn-sna_Latn,119295,1755380,80588,119295,997606,79145,2752986
ceb_Latn-swe_Latn,86844,1471189,100381,86844,1273254,96469,2744443
deu_Latn-kan_Knda,100513,1558909,86024,100513,1163640,88171,2722549
ful_Latn-ibo_Latn,111373,1142286,80672,111373,1578706,91478,2720992
amh_Ethi-nso_Latn,141448,992061,20059,141448,1728831,91553,2720892
mon_Cyrl-nep_Deva,84885,1339200,91032,84885,1375132,51915,2714332
aze_Latn-sin_Sinh,99902,1278602,94845,99902,1434086,99350,2712688
ban_Latn-jav_Latn,110651,1432383,76286,110651,1270716,73633,2703099
nep_Deva-pus_Arab,84479,1206271,38633,84479,1482904,85418,2689175
nep_Deva-yor_Latn,59011,1206419,44746,59011,1466932,82613,2673351
ful_Latn-tir_Ethi,124021,1504789,104587,124021,1166666,8535,2671455
hne_Deva-tel_Telu,146732,1582153,14270,146732,1084093,129490,2666246
zho_Hani-yid_Hebr,410355,425993,667926,410355,2234583,356867,2660576
ara_Arab-zul_Latn,100070,1317517,87654,100070,1336050,91924,2653567
mya_Mymr-nep_Deva,111114,967325,57799,111114,1663452,54918,2630777
aze_Latn-mar_Deva,100887,1269125,95736,100887,1360018,95572,2629143
ban_Latn-mlg_Latn,98113,1401657,70600,98113,1222133,64471,2623790
deu_Latn-guj_Gujr,132328,1286236,83637,132328,1330810,91183,2617046
ace_Latn-jav_Latn,124543,1373883,84617,124543,1241995,85005,2615878
ara_Arab-ibo_Latn,78910,1224680,79374,78910,1377411,79282,2602091
fon_Latn-hau_Latn,103594,1416934,61589,103594,1180192,62396,2597126
fon_Latn-sot_Latn,97368,1374699,58690,97368,1208003,57252,2582702
aze_Latn-hau_Latn,72411,1168063,73720,72411,1401349,72696,2569412
ara_Arab-guj_Gujr,112925,1245548,85758,112925,1315365,92967,2560913
fon_Latn-kin_Latn,105300,1575857,71188,105300,956424,68279,2532281
hne_Deva-nep_Deva,158905,1334142,29619,158905,1165338,27399,2499480
ben_Beng-hne_Deva,153143,1131359,181398,153143,1366853,16580,2498212
bam_Latn-swa_Latn,146168,1468171,90745,146168,1018074,86309,2486245
ara_Arab-sna_Latn,77000,1262638,95333,77000,1195178,85592,2457816
hau_Latn-kon_Latn,135579,1221730,64593,135579,1232196,57582,2453926
amh_Ethi-aze_Latn,82510,1238783,72550,82510,1206944,88611,2445727
ara_Arab-lat_Latn,155301,1188380,105296,155301,1256764,79259,2445144
dyu_Latn-yor_Latn,102264,1209735,59450,102264,1222928,64375,2432663
nep_Deva-sna_Latn,64413,1356241,29074,64413,1063652,76259,2419893
aze_Latn-hat_Latn,73369,1070959,76062,73369,1348321,76852,2419280
aze_Latn-nep_Deva,84119,1136240,85461,84119,1266937,48818,2403177
hne_Deva-tam_Taml,143800,1443134,21260,143800,959918,107675,2403052
asm_Beng-mai_Deva,157333,1081000,191510,157333,1310167,24044,2391167
ful_Latn-sna_Latn,122866,1279868,99377,122866,1108116,101537,2387984
fon_Latn-tsn_Latn,100092,1251066,57434,100092,1129876,50345,2380942
dyu_Latn-zul_Latn,124546,1512101,76783,124546,864214,73707,2376315
ara_Arab-kan_Knda,104751,1244621,88847,104751,1131401,84757,2376022
afr_Latn-bam_Latn,121669,1006668,67527,121669,1363367,82888,2370035
ceb_Latn-hin_Deva,66873,1175559,56714,66873,1169810,4873,2345369
dyu_Latn-sna_Latn,111240,1449750,71962,111240,893563,69448,2343313
awa_Deva-ori_Orya,124858,1375267,20416,124858,964229,13766,2339496
afr_Latn-dyu_Latn,130797,1041783,69311,130797,1295883,72672,2337666
bel_Cyrl-hrv_Latn,136404,1260098,104104,136404,1070548,107622,2330646
dyu_Latn-nya_Latn,100915,1352092,67735,100915,976727,67452,2328819
ara_Arab-pan_Guru,125803,1129812,76192,125803,1182876,68600,2312688
ful_Latn-sot_Latn,100571,981264,77622,100571,1322768,79732,2304032
awa_Deva-snd_Arab,100404,1277621,22093,100404,1025761,62153,2303382
deu_Latn-pan_Guru,136989,1110126,81114,136989,1192719,66281,2302845
ewe_Latn-nso_Latn,111438,1081879,57802,111438,1210012,60165,2291891
aka_Latn-swa_Latn,165297,1379485,81452,165297,910489,68551,2289974
zho_Hani-glg_Latn,216969,310083,302828,216969,1974891,153862,2284974
ewe_Latn-kon_Latn,104606,1102742,49608,104606,1180058,52100,2282800
aka_Latn-eng_Latn,133151,1272575,105674,133151,1000690,269536,2273265
hne_Deva-urd_Arab,97694,1027830,11094,97694,1227841,23329,2255671
eng_Latn-ltg_Latn,132115,1267251,262077,132115,987481,104774,2254732
asm_Beng-san_Deva,146417,1268365,177255,146417,979582,11325,2247947
deu_Latn-nya_Latn,71477,1155433,76663,71477,1077300,75831,2232733
ace_Latn-war_Latn,116222,1101942,66137,116222,1130525,64794,2232467
zho_Hani-bel_Cyrl,199838,291206,245092,199838,1902721,126601,2193927
bak_Cyrl-uig_Arab,109865,1109034,88793,109865,1082419,82318,2191453
fon_Latn-twi_Latn,87187,1232055,51944,87187,948851,47939,2180906
ara_Arab-nya_Latn,72310,1122025,73421,72310,1054131,74051,2176156
afr_Latn-ssw_Latn,184222,1195632,77720,184222,977891,80127,2173523
fon_Latn-yor_Latn,83401,1194123,54383,83401,968385,53992,2162508
amh_Ethi-fon_Latn,91957,727080,10717,91957,1432289,63753,2159369
aze_Latn-mlg_Latn,70037,967540,77600,70037,1178332,78380,2145872
aze_Latn-tgk_Cyrl,78861,1045897,73913,78861,1095301,69602,2141198
fon_Latn-run_Latn,88941,1324936,56691,88941,812946,54932,2137882
ewe_Latn-fon_Latn,78329,956098,44980,78329,1179857,48987,2135955
aze_Latn-som_Latn,60045,1064740,68971,60045,1066491,60981,2131231
ibo_Latn-nep_Deva,53126,1125695,66767,53126,1002106,38363,2127801
dyu_Latn-kin_Latn,102900,1246033,63127,102900,851087,62243,2097120
hau_Latn-kmb_Latn,95333,1110123,52202,95333,970171,41956,2080294
hau_Latn-kik_Latn,114660,1142484,63731,114660,936791,53412,2079275
bel_Cyrl-sqi_Latn,121608,952030,88451,121608,1126567,80678,2078597
khm_Khmr-nep_Deva,128752,793878,68739,128752,1277090,67334,2070968
kur_Latn-nep_Deva,68661,1086471,64843,68661,982980,36491,2069451
kir_Cyrl-nep_Deva,82145,1002129,73347,82145,1065965,46928,2068094
grn_Latn-spa_Latn,54444,828016,49002,54444,1234457,50603,2062473
amh_Ethi-dyu_Latn,94747,751396,10387,94747,1308993,67952,2060389
aka_Latn-yor_Latn,113759,1079311,55722,113759,979984,63130,2059295
kan_Knda-nep_Deva,68293,880835,64865,68293,1175612,17740,2056447
ace_Latn-ilo_Latn,102209,1078360,60799,102209,964991,63485,2043351
ful_Latn-orm_Latn,92791,938168,73802,92791,1101930,82863,2040098
ara_Arab-jav_Latn,242407,1044976,52947,242407,994523,53708,2039499
ceb_Latn-spa_Latn,58747,1088801,55207,58747,950609,41531,2039410
fon_Latn-xho_Latn,90614,1337823,57854,90614,685208,55486,2023031
zho_Hani-mar_Deva,156512,187381,192756,156512,1825067,142179,2012448
bjn_Latn-jav_Latn,116224,1046732,78431,116224,962959,79749,2009691
afr_Latn-kik_Latn,127718,1019501,61046,127718,986738,59621,2006239
amh_Ethi-kon_Latn,104560,734382,11818,104560,1267531,58981,2001913
aze_Latn-mon_Cyrl,74885,960379,71524,74885,1030425,72017,1990804
ace_Latn-mri_Latn,63518,856668,45105,63518,1129646,42832,1986314
ceb_Latn-fra_Latn,55440,1058022,51699,55440,927046,53722,1985068
aze_Latn-cym_Latn,70879,906556,61435,70879,1074867,60824,1981423
ful_Latn-lug_Latn,91880,989145,68651,91880,962463,70297,1951608
zho_Hani-nep_Deva,163063,237873,188589,163063,1712854,42549,1950727
aze_Latn-sun_Latn,61486,926847,65422,61486,1023826,66580,1950673
epo_Latn-nep_Deva,93980,945605,48077,93980,976454,12445,1922059
aka_Latn-amh_Ethi,91812,1333985,80086,91812,580085,11998,1914070
ceb_Latn-por_Latn,52109,1031729,48314,52109,874999,47753,1906728
dyu_Latn-tsn_Latn,94311,952746,50336,94311,952940,46898,1905686
zho_Hani-epo_Latn,155898,214944,217287,155898,1689978,114569,1904922
ceb_Latn-ita_Latn,55370,1046509,51466,55370,856990,31081,1903499
hne_Deva-mal_Mlym,112554,1138572,12437,112554,762098,93983,1900670
fon_Latn-lin_Latn,69794,1084084,41462,69794,809113,39720,1893197
ace_Latn-sun_Latn,89487,1010784,62915,89487,874846,64654,1885630
deu_Latn-zul_Latn,70219,1039716,64849,70219,845177,62044,1884893
gla_Latn-nld_Latn,136186,882225,89369,136186,998561,88488,1880786
dyu_Latn-sot_Latn,87494,951416,49856,87494,918765,48136,1870181
afr_Latn-kmb_Latn,115396,860577,54424,115396,1003049,53916,1863626
dyu_Latn-tso_Latn,82065,939387,47230,82065,915137,43556,1854524
hau_Latn-nep_Deva,52952,978880,57389,52952,875346,36288,1854226
ceb_Latn-tha_Thai,31632,870353,27368,31632,970627,137,1840980
bho_Deva-snd_Arab,100046,960872,18781,100046,878759,59831,1839631
dyu_Latn-twi_Latn,82974,980770,49200,82974,857484,47339,1838254
bam_Latn-som_Latn,71309,922015,45835,71309,913719,50096,1835734
kur_Arab-zho_Hani,112727,1697197,79950,112727,138122,181312,1835319
bam_Latn-hau_Latn,76968,914435,44451,76968,903551,47029,1817986
aze_Latn-kur_Latn,45619,732303,48094,45619,1082533,44694,1814836
aka_Latn-hau_Latn,98866,948513,45336,98866,864452,48568,1812965
deu_Latn-tat_Cyrl,65362,918315,65400,65362,891552,62320,1809867
ban_Latn-mri_Latn,52132,789418,41227,52132,1005952,35823,1795370
ful_Latn-tsn_Latn,88938,764462,60459,88938,1027449,55997,1791911
ceb_Latn-ron_Latn,42972,966796,39887,42972,816058,42950,1782854
ceb_Latn-nld_Latn,44710,922120,41267,44710,847703,58599,1769823
ban_Latn-war_Latn,87763,877672,53579,87763,891784,49859,1769456
zho_Hani-tel_Telu,168364,200735,207417,168364,1568195,119802,1768930
ceb_Latn-kek_Latn,30689,857420,26758,30689,900137,66789,1757557
zho_Hani-aze_Latn,142215,163826,216152,142215,1581322,102128,1745148
ceb_Latn-rus_Cyrl,52804,1032032,49069,52804,713116,45923,1745148
hau_Latn-orm_Latn,118241,941271,61202,118241,799681,63131,1740952
bjn_Latn-ceb_Latn,97541,853560,62298,97541,885051,61233,1738611
ceb_Latn-nor_Latn,41304,940029,37490,41304,798582,35719,1738611
hne_Deva-kan_Knda,98061,1027087,10512,98061,709512,74285,1736599
aze_Latn-mya_Mymr,85938,917095,79116,85938,808174,69828,1725269
dyu_Latn-ewe_Latn,70854,898767,45080,70854,823738,40106,1722505
fon_Latn-ful_Latn,81486,861580,62844,81486,849411,68785,1710991
eus_Latn-nep_Deva,155834,802928,57321,155834,903052,22802,1705980
fon_Latn-tum_Latn,73674,1038284,43721,73674,660471,43319,1698755
bho_Deva-san_Deva,89840,1092099,11762,89840,592882,5080,1684981
deu_Latn-lat_Latn,53636,940249,51469,53636,742942,22970,1683191
nep_Deva-nya_Latn,47614,869201,35005,47614,812826,58903,1682027
ace_Latn-smo_Latn,63113,716865,41526,63113,961902,43326,1678767
aze_Latn-bos_Latn,49483,858265,46228,49483,814867,34649,1673132
amh_Ethi-kik_Latn,93071,695419,10854,93071,976498,58117,1671917
ceb_Latn-pol_Latn,47970,967420,44145,47970,701932,44344,1669352
ban_Latn-ilo_Latn,80552,876221,53842,80552,788933,52199,1665154
nah_Latn-spa_Latn,33638,712018,35554,33638,952926,38252,1664944
aka_Latn-som_Latn,78243,840545,42952,78243,821304,49371,1661849
dyu_Latn-xho_Latn,88183,1040873,52099,88183,620547,49622,1661420
ceb_Latn-ces_Latn,45100,968686,41147,45100,692533,45380,1661219
bul_Cyrl-ceb_Latn,41840,725575,37324,41840,935084,37993,1660659
dyu_Latn-luo_Latn,64151,904861,42137,64151,751727,41780,1656588
afr_Latn-ceb_Latn,31071,792761,26742,31071,860865,26973,1653626
ban_Latn-sun_Latn,65706,900034,49982,65706,750209,49295,1650243
ceb_Latn-hun_Latn,43316,954558,39525,43316,675236,38702,1629794
dyu_Latn-ibo_Latn,63641,797915,37120,63641,824880,39566,1622795
dyu_Latn-lug_Latn,77306,943529,43577,77306,674245,41819,1617774
ceb_Latn-pck_Latn,30842,859907,26860,30842,757683,28745,1617590
asm_Beng-bho_Deva,83980,690633,99504,83980,922741,16252,1613374
aze_Latn-khm_Khmr,104130,960356,83173,104130,651704,55003,1612060
ceb_Latn-sqi_Latn,31215,861675,27054,31215,747977,29189,1609652
ace_Latn-fij_Latn,60626,707239,38422,60626,898025,39143,1605264
ful_Latn-run_Latn,79981,808294,61274,79981,784010,61630,1592304
aze_Latn-yor_Latn,41543,683226,52837,41543,906165,53091,1589391
ceb_Latn-som_Latn,30861,860159,26882,30861,722966,30683,1583125
ben_Beng-kas_Arab,137816,719265,175291,137816,859953,19883,1579218
deu_Latn-kek_Latn,30431,688264,26873,30431,886503,65856,1574767
ceb_Latn-mal_Mlym,59669,1024015,52617,59669,550623,50341,1574638
ceb_Latn-ell_Grek,31475,866199,27340,31475,707958,24938,1574157
glg_Latn-oci_Latn,119815,768190,69667,119815,796374,66500,1564564
fon_Latn-luo_Latn,56575,912452,36404,56575,650103,35634,1562555
ceb_Latn-plt_Latn,30689,854366,26725,30689,704523,28827,1558889
deu_Latn-uzb_Cyrl,81810,810572,47108,81810,739660,67816,1550232
ful_Latn-tso_Latn,67228,671730,49405,67228,871347,46569,1543077
ceb_Latn-epo_Latn,31220,862389,27088,31220,676653,26830,1539042
ewe_Latn-kmb_Latn,62524,766074,36657,62524,771523,37139,1537597
ceb_Latn-fin_Latn,41189,931755,37345,41189,599774,40667,1531529
fon_Latn-nso_Latn,58691,801004,36835,58691,728366,34162,1529370
hau_Latn-wol_Latn,77045,810587,45345,77045,714670,40146,1525257
amh_Ethi-orm_Latn,106475,634509,15586,106475,890715,77421,1525224
ceb_Latn-isl_Latn,30846,857783,26861,30846,665125,33376,1522908
kek_Latn-nep_Deva,29715,864915,64347,29715,657701,26,1522616
bjn_Latn-war_Latn,111196,745878,65254,111196,771252,64781,1517130
ceb_Latn-dan_Latn,31072,858542,26968,31072,653830,21196,1512372
ceb_Latn-slv_Latn,31238,862811,27064,31238,646228,27976,1509039
ceb_Latn-nep_Deva,30168,840580,26301,30168,663928,39,1504508
ewe_Latn-ful_Latn,78065,773615,43446,78065,726575,56381,1500190
hne_Deva-mar_Deva,85078,828253,7273,85078,671622,59088,1499875
bjn_Latn-mlg_Latn,87160,762559,57819,87160,732859,53912,1495418
awa_Deva-san_Deva,80294,954246,11887,80294,532868,4794,1487114
aze_Latn-kir_Cyrl,64466,731527,57376,64466,752992,58325,1484519
ceb_Latn-slk_Latn,31122,861345,27017,31122,618895,28698,1480240
fon_Latn-tir_Ethi,59560,937609,40780,59560,537841,3070,1475450
nep_Deva-pan_Guru,78086,721466,30277,78086,749903,42502,1471369
ceb_Latn-mar_Deva,30179,835219,26273,30179,634881,61480,1470100
aze_Latn-pus_Arab,55971,622271,49711,55971,827887,50142,1450158
deu_Latn-pck_Latn,30811,693930,27117,30811,754097,28658,1448027
fon_Latn-lug_Latn,64910,887493,39506,64910,558880,35869,1446373
ceb_Latn-srp_Latn,31159,861665,27029,31159,584652,26514,1446317
ara_Arab-ceb_Latn,41648,509185,49069,41648,930104,37831,1439289
ceb_Latn-hrv_Latn,31212,862324,27154,31212,574558,29609,1436882
zho_Hani-som_Latn,87918,96945,121601,87918,1335905,64547,1432850
nep_Deva-zul_Latn,43432,796415,20505,43432,631923,48656,1428338
dyu_Latn-tum_Latn,69109,817981,41265,69109,606350,42139,1424331
bam_Latn-yor_Latn,61936,714782,36490,61936,704442,38780,1419224
fon_Latn-ibo_Latn,55153,746394,33611,55153,670018,34113,1416412
bre_Latn-deu_Latn,124317,740706,61565,124317,664155,59573,1404861
nep_Deva-pck_Latn,30150,662970,26,30150,736263,27987,1399233
bel_Cyrl-epo_Latn,89366,666865,65677,89366,730218,61227,1397083
deu_Latn-plt_Latn,30682,690485,26994,30682,703028,28822,1393513
afr_Latn-ltz_Latn,67490,711297,56119,67490,681513,60879,1392810
ace_Latn-pag_Latn,63081,714893,39765,63081,671773,39832,1386666
ace_Latn-ban_Latn,48082,681027,34564,48082,702897,37433,1383924
bjn_Latn-ilo_Latn,94302,688462,58893,94302,695450,59578,1383912
dyu_Latn-run_Latn,72607,816691,42311,72607,556198,41491,1372889
guj_Gujr-kas_Arab,72827,566354,48548,72827,799046,8682,1365400
fon_Latn-kon_Latn,57873,737424,30176,57873,617276,27762,1354700
zho_Hani-mri_Latn,52794,62436,57276,52794,1289389,17372,1351825
ceb_Latn-lat_Latn,29704,832175,25870,29704,517777,71,1349952
ful_Latn-twi_Latn,77848,688995,51555,77848,658438,39580,1347433
nep_Deva-plt_Latn,30007,660290,26,30007,686014,28196,1346304
ban_Latn-smo_Latn,45320,589002,34062,45320,750443,33371,1339445
dyu_Latn-tir_Ethi,55861,814176,41541,55861,517894,2082,1332070
hau_Latn-ssw_Latn,89943,830716,47446,89943,498514,37412,1329230
afr_Latn-aka_Latn,96752,531270,37386,96752,793356,49789,1324626
ara_Arab-nds_Latn,120506,624801,44608,120506,694269,52861,1319070
aze_Latn-ibo_Latn,39124,588061,44061,39124,726390,44532,1314451
deu_Latn-nno_Latn,112578,637220,48024,112578,672227,41519,1309447
ceb_Latn-kor_Hang,30578,848232,26717,30578,457262,301,1305494
ceb_Latn-sna_Latn,30526,851127,26603,30526,451947,27426,1303074
ceb_Latn-kan_Knda,30171,828650,26203,30171,472872,35163,1301522
fon_Latn-kmb_Latn,44267,712273,24144,44267,587785,23729,1300058
ceb_Latn-lit_Latn,30266,834491,26431,30266,460687,32018,1295178
eng_Latn-asm_Beng,117974,637080,149451,117974,655961,132836,1293041
bjn_Latn-sun_Latn,75458,676664,55673,75458,610517,57484,1287181
ara_Arab-gle_Latn,104289,582868,36388,104289,703517,39244,1286385
ceb_Latn-xho_Latn,30400,847702,26475,30400,437382,27784,1285084
guj_Gujr-hne_Deva,70266,573654,44806,70266,709248,7491,1282902
eng_Latn-sat_Olck,78691,701833,137254,78691,574107,9004,1275940
bho_Deva-mai_Deva,72409,666013,11565,72409,598774,9995,1264787
ceb_Latn-tur_Latn,29561,818768,25840,29561,444617,41793,1263385
deu_Latn-snd_Arab,26249,606131,33519,26249,651906,23544,1258037
asm_Beng-awa_Deva,61192,516365,72751,61192,737707,9389,1254072
ara_Arab-ber_Latn,31538,419913,37707,31538,832239,30055,1252152
hne_Deva-ori_Orya,62418,657306,6795,62418,594701,7493,1252007
zho_Hani-hye_Armn,111406,141100,127945,111406,1109420,51898,1250520
bjn_Latn-mri_Latn,51989,524708,38247,51989,722010,35849,1246718
ceb_Latn-tel_Telu,29656,816449,25860,29656,429263,27885,1245712
amh_Ethi-kmb_Latn,62338,487548,6048,62338,751719,40726,1239267
zho_Hani-amh_Ethi,89457,106828,117560,89457,1126708,24136,1233536
mya_Mymr-zho_Hani,132912,1081825,21004,132912,150578,189825,1232403
ceb_Latn-heb_Hebr,30093,826901,26127,30093,405454,285,1232355
ceb_Latn-fil_Latn,43594,619906,36836,43594,611806,35315,1231712
bam_Latn-zul_Latn,66599,776429,43358,66599,445079,40031,1221508
dyu_Latn-nso_Latn,65213,620682,34953,65213,598291,32124,1218973
deu_Latn-uig_Arab,29075,631197,35178,29075,587608,8427,1218805
amh_Ethi-ceb_Latn,29059,402037,7,29059,811327,25482,1213364
bam_Latn-nya_Latn,52869,707275,37398,52869,505725,35770,1213000
dyu_Latn-lin_Latn,57758,654056,33523,57758,555557,32031,1209613
ban_Latn-fij_Latn,46175,527465,32993,46175,676952,31421,1204417
ewe_Latn-kik_Latn,61481,635938,31731,61481,568441,32936,1204379
aka_Latn-zul_Latn,82106,767410,38867,82106,430293,32015,1197703
bam_Latn-sna_Latn,57444,736087,38522,57444,450550,36016,1186637
bel_Cyrl-hin_Deva,71433,556184,50043,71433,629236,12180,1185420
nep_Deva-nno_Latn,122074,601065,20186,122074,581226,36322,1182291
ewe_Latn-wol_Latn,54656,589133,27436,54656,587766,33267,1176899
ara_Arab-kek_Latn,27501,397344,34369,27501,771363,57587,1168707
lat_Latn-nep_Deva,29652,512077,47,29652,648301,34,1160378
ful_Latn-luo_Latn,55188,568147,43815,55188,591818,45460,1159965
asm_Beng-mag_Deva,72236,497883,85725,72236,656665,9463,1154548
deu_Latn-div_Thaa,25934,604548,33392,25934,549094,53726,1153642
ara_Arab-pck_Latn,29919,422962,36881,29919,716480,27128,1139442
glg_Latn-nep_Deva,85457,603067,44278,85457,533913,16427,1136980
hin_Deva-hne_Deva,83142,553694,8042,83142,582496,10610,1136190
zho_Hani-tgk_Cyrl,109571,179662,142223,109571,955914,57125,1135576
amh_Ethi-wol_Latn,63492,449781,9851,63492,680572,43209,1130353
ful_Latn-nso_Latn,55960,487902,37155,55960,633329,34684,1121231
bam_Latn-tsn_Latn,55221,566249,31511,55221,554105,28187,1120354
ewe_Latn-orm_Latn,74453,565982,35391,74453,548475,46625,1114457
aka_Latn-twi_Latn,76646,654460,32440,76646,459536,22461,1113996
dyu_Latn-fon_Latn,41425,506673,25199,41425,606848,26214,1113521
ceb_Latn-min_Latn,97608,570623,40178,97608,540056,40366,1110679
bam_Latn-kin_Latn,56278,657328,35919,56278,450390,33891,1107718
bjn_Latn-fij_Latn,59684,444668,40258,59684,659332,42280,1104000
ara_Arab-hbs_Latn,39397,545112,40280,39397,554122,50925,1099234
ful_Latn-tum_Latn,60258,557264,41472,60258,539605,42966,1096869
deu_Latn-kin_Latn,50818,629624,45065,50818,465464,50539,1095088
ara_Arab-plt_Latn,29875,422625,37017,29875,671390,27516,1094015
aze_Latn-mri_Latn,35851,457974,34068,35851,633899,34165,1091873
aka_Latn-kin_Latn,67110,645567,34501,67110,442226,29453,1087793
hne_Deva-sin_Sinh,60033,567154,8728,60033,514808,53288,1081962
bam_Latn-ful_Latn,38112,595745,33891,38112,467111,31465,1062856
hin_Deva-kas_Arab,85753,487264,12627,85753,574736,14885,1062000
aka_Latn-ewe_Latn,64247,620039,33808,64247,437086,20745,1057125
amh_Ethi-bam_Latn,49211,377101,6263,49211,666365,37452,1043466
bam_Latn-twi_Latn,44129,559004,28964,44129,480070,26220,1039074
kat_Geor-zho_Hani,132389,890589,119073,132389,142015,176455,1032604
zho_Hani-kaz_Cyrl,129155,185681,153326,129155,846917,61825,1032598
aka_Latn-nya_Latn,52329,608853,30764,52329,415258,28775,1024111
ara_Arab-lao_Laoo,62561,596717,35710,62561,422493,32336,1019210
ful_Latn-lin_Latn,50165,479268,36175,50165,539650,34294,1018918
fon_Latn-orm_Latn,50662,601813,31112,50662,406092,33113,1007905
bjn_Latn-smo_Latn,50050,414609,34761,50050,583629,34579,998238
bam_Latn-sot_Latn,48582,517387,29142,48582,477227,26672,994614
ara_Arab-bre_Latn,98709,464728,31789,98709,527522,42230,992250
aka_Latn-sna_Latn,68070,622859,31673,68070,365727,27065,988586
ace_Latn-bjn_Latn,49113,492136,35057,49113,490121,35177,982257
ban_Latn-pag_Latn,39861,513209,26968,39861,466858,26162,980067
aka_Latn-xho_Latn,70540,620254,33419,70540,352958,27861,973212
ful_Latn-wol_Latn,46962,465312,32133,46962,505640,30803,970952
zho_Hani-nob_Latn,110678,183240,140882,110678,769659,46624,952899
bam_Latn-tso_Latn,41602,491390,25756,41602,460611,22743,952001
zho_Hani-kek_Latn,30889,30889,32991,30889,913341,67813,944230
aka_Latn-fon_Latn,46380,504729,29213,46380,437245,33000,941974
bar_Latn-deu_Latn,30065,468396,39123,30065,472232,41483,940628
aka_Latn-sot_Latn,61108,515332,28665,61108,421395,23677,936727
crh_Latn-uzb_Latn,64294,477598,46081,64294,456535,46064,934133
eng_Latn-cak_Latn,14991,339613,30941,14991,591273,28985,930886
bam_Latn-ibo_Latn,37294,459127,22402,37294,465247,23292,924374
hne_Deva-san_Deva,51816,580892,3351,51816,337647,3332,918539
dyu_Latn-kon_Latn,42983,459562,21961,42983,457660,21143,917222
nds_Latn-nep_Deva,92076,457093,32879,92076,459107,17081,916200
bel_Cyrl-ben_Beng,65106,500326,43797,65106,414372,83301,914698
crh_Latn-kir_Cyrl,65877,482097,47721,65877,432298,48238,914395
bam_Latn-ewe_Latn,35487,477784,25191,35487,432935,21050,910719
zho_Hani-xho_Latn,86446,123903,97770,86446,784429,51558,908332
deu_Latn-lao_Laoo,56710,515871,35497,56710,391431,30729,907302
aze_Latn-nya_Latn,31538,443615,34065,31538,463448,34622,907063
eng_Latn-djk_Latn,14862,339132,30767,14862,566125,34443,905257
zho_Hani-hat_Latn,63663,98248,68741,63663,806710,42202,904958
ewe_Latn-ssw_Latn,53708,542232,27853,53708,355518,29440,897750
dyu_Latn-wol_Latn,33193,482779,22528,33193,414283,22169,897062
bam_Latn-lug_Latn,43035,522350,25362,43035,374373,23802,896723
zho_Hani-ceb_Latn,31162,31271,33468,31162,863637,27177,894908
hin_Deva-jav_Latn,52253,495421,7914,52253,392658,46556,888079
amh_Ethi-ssw_Latn,63202,443084,8108,63202,435820,39595,878904
eng_Latn-quc_Latn,15443,347323,31844,15443,526206,27363,873529
asm_Beng-deu_Latn,73635,435049,79566,73635,433158,25172,868207
aka_Latn-tso_Latn,51269,476120,22382,51269,391593,16548,867713
bam_Latn-luo_Latn,31393,464859,23160,31393,380277,21972,845136
ara_Arab-nno_Latn,76686,404731,26006,76686,439692,26762,844423
bam_Latn-xho_Latn,47392,531966,29041,47392,311105,26344,843071
aka_Latn-tsn_Latn,54072,451858,26634,54072,389023,21010,840881
ast_Latn-oci_Latn,33637,570542,32808,33637,269607,23421,840149
zho_Hani-nds_Latn,111383,193413,136836,111383,643347,45824,836760
zho_Hani-mon_Cyrl,81769,116395,94289,81769,710692,47475,827087
ara_Arab-div_Thaa,16001,456789,13031,16001,361590,25901,818379
aze_Latn-pan_Guru,28191,376914,25804,28191,437442,24282,814356
ara_Arab-uig_Arab,12723,447323,12956,12723,359142,4469,806465
ban_Latn-bjn_Latn,34783,400932,26080,34783,403191,24650,804123
aze_Latn-xho_Latn,29626,409694,31831,29626,393676,32300,803370
zho_Hani-cym_Latn,96375,156061,108185,96375,640659,37162,796720
aze_Latn-guj_Gujr,27046,388769,26954,27046,405391,25665,794160
ara_Arab-arz_Arab,21050,393080,23619,21050,400010,24320,793090
zho_Hani-pck_Latn,30956,30956,33059,30956,761609,28956,792565
bam_Latn-run_Latn,39663,469758,24816,39663,322111,23486,791869
nob_Latn-nep_Deva,71118,390414,25023,71118,395835,14068,786249
bho_Deva-mag_Deva,33210,389001,10484,33210,392618,3786,781619
hne_Deva-snd_Arab,38585,386654,3756,38585,393797,24140,780451
zho_Hani-khm_Khmr,125035,202863,147059,125035,577403,34995,780266
bho_Deva-hne_Deva,27758,402432,10590,27758,374426,2893,776858
eng_Latn-mam_Latn,15387,345438,31700,15387,425171,22415,770609
ful_Latn-kon_Latn,34989,329564,20984,34989,434110,20491,763674
dyu_Latn-ful_Latn,32888,426807,25097,32888,328629,25146,755436
asm_Beng-hne_Deva,37224,339659,45005,37224,409357,3726,749016
eng_Latn-amu_Latn,15617,349939,32165,15617,396313,27981,746252
dzo_Tibt-eng_Latn,56441,266479,17800,56441,479570,119205,746049
aze_Latn-uig_Arab,18246,366261,18081,18246,378653,4552,744914
aka_Latn-run_Latn,47685,453035,23295,47685,291294,18326,744329
gle_Latn-nep_Deva,74103,388391,24384,74103,354111,15817,742502
aka_Latn-ibo_Latn,39240,377383,18202,39240,363879,20585,741262
zho_Hani-plt_Latn,30767,30767,32867,30767,707316,29011,738083
aze_Latn-snd_Arab,14080,353849,17349,14080,382778,11881,736627
zho_Hani-kan_Knda,61696,79031,68326,61696,654623,47377,733654
bam_Latn-tum_Latn,35323,425291,22128,35323,306853,21606,732144
aze_Latn-uzb_Cyrl,27075,354843,17509,27075,373145,28902,727988
eng_Latn-rom_Latn,16519,357876,33937,16519,369746,17522,727622
aze_Latn-div_Thaa,14713,356505,17449,14713,368810,27082,725315
eng_Latn-ppk_Latn,15396,345633,31826,15396,377659,26712,723292
bam_Latn-lin_Latn,32689,392040,20627,32689,329161,18816,721201
zho_Hani-hau_Latn,51565,63263,73071,51565,655390,31995,718653
aka_Latn-tir_Ethi,33953,467524,22149,33953,250427,2502,717951
aka_Latn-lug_Latn,45940,420031,20821,45940,297912,19104,717943
eng_Latn-wln_Latn,76838,316969,95752,76838,400355,16853,717324
fon_Latn-kik_Latn,34691,429070,23201,34691,287548,20106,716618
bel_Cyrl-swa_Latn,40153,338788,29919,40153,375063,29627,713851
dyu_Latn-kik_Latn,34319,389617,20419,34319,311547,18840,701164
zho_Hani-sna_Latn,44958,50540,48585,44958,650518,41473,701058
ben_Beng-ilo_Latn,43765,349304,53238,43765,348121,36505,697425
bam_Latn-fon_Latn,25516,315775,16868,25516,381397,16526,697172
aze_Latn-kan_Knda,26748,375040,24898,26748,319098,22761,694138
bam_Latn-tir_Ethi,28780,424428,22154,28780,268126,1425,692554
bak_Cyrl-crh_Latn,48150,359185,37623,48150,328501,35504,687686
fij_Latn-min_Latn,55198,408337,26210,55198,276849,24776,685186
hne_Deva-pan_Guru,32262,344809,3151,32262,329007,4421,673816
awa_Deva-mai_Deva,39894,365234,4845,39894,307125,5308,672359
aka_Latn-nso_Latn,46132,370322,18406,46132,301094,13875,671416
aze_Latn-zul_Latn,25143,342262,25846,25143,328202,26480,670464
aka_Latn-orm_Latn,47074,380322,21659,47074,282656,22543,662978
ceb_Latn-mya_Mymr,18147,464589,16020,18147,197062,27,661651
dyu_Latn-orm_Latn,45724,369921,23614,45724,289181,25584,659102
bam_Latn-nso_Latn,34966,340702,19269,34966,315793,16761,656495
fon_Latn-ssw_Latn,31016,434014,19180,31016,221080,18321,655094
deu_Latn-hne_Deva,76528,284404,24517,76528,366507,23807,650911
aze_Latn-sna_Latn,21335,324151,26221,21335,324713,26853,648864
dan_Latn-yid_Hebr,59377,337023,40250,59377,303503,48721,640526
bos_Latn-nep_Deva,35755,310463,17513,35755,319435,5624,629898
zho_Hani-nno_Latn,81549,147825,100833,81549,480600,29281,628425
eng_Latn-arg_Latn,26816,303384,52483,26816,323971,25345,627355
deu_Latn-oci_Latn,53168,299019,30941,53168,326165,26327,625184
hin_Deva-ilo_Latn,35060,353614,3085,35060,270182,29555,623796
eng_Latn-bak_Cyrl,28008,347200,59080,28008,275398,29676,622598
eng_Latn-wal_Latn,15446,346880,31841,15446,252555,17854,599435
ara_Arab-hne_Deva,66733,269720,18895,66733,325573,21567,595293
aka_Latn-wol_Latn,39015,334564,13613,39015,260632,9688,595196
hne_Deva-mai_Deva,28815,289098,2571,28815,304010,3431,593108
hne_Deva-mag_Deva,20505,286572,1787,20505,305833,3113,592405
aka_Latn-tum_Latn,36786,357148,17075,36786,234077,15350,591225
bam_Latn-dyu_Latn,23477,301007,15906,23477,290106,15035,591113
eng_Latn-chr_Cher,15830,353922,32575,15830,232454,13830,586376
aka_Latn-lin_Latn,36195,331303,17063,36195,254975,13320,586278
eng_Latn-quw_Latn,15734,352103,32351,15734,232493,21772,584596
eng_Latn-syr_Syrc,15832,352538,32496,15832,218517,1,571055
eng_Latn-cha_Latn,14658,296288,32058,14658,269846,12996,566134
zho_Hani-guj_Gujr,52811,97179,58895,52811,468014,34847,565193
lao_Laoo-nep_Deva,28279,227001,19524,28279,336006,14280,563007
gla_Latn-nor_Latn,42679,284299,31714,42679,277588,28390,561887
bak_Cyrl-deu_Latn,26969,249760,28250,26969,309879,31672,559639
zho_Hani-sun_Latn,50756,61665,54623,50756,496836,28274,558501
aka_Latn-luo_Latn,32766,319549,18055,32766,238368,16106,557917
bjn_Latn-pag_Latn,35687,287236,20085,35687,269924,19701,557160
eng_Latn-shi_Latn,15581,347151,32062,15581,207733,21196,554884
bam_Latn-kon_Latn,24654,281222,13601,24654,271283,12430,552505
zho_Hani-lat_Latn,30246,30360,32354,30246,521959,62,552319
zho_Hani-hbs_Latn,37090,43612,72943,37090,508437,48953,552049
ace_Latn-min_Latn,36358,288828,20400,36358,259313,18608,548141
ful_Latn-kik_Latn,27111,265942,18191,27111,270943,16906,536885
dan_Latn-gla_Latn,47062,253353,31140,47062,280140,34296,533493
ful_Latn-ssw_Latn,30445,290789,21682,30445,227724,21099,518513
bam_Latn-wol_Latn,20322,285054,14794,20322,233156,12909,518210
awa_Deva-bho_Deva,23904,269315,3630,23904,247872,4086,517187
awa_Deva-hne_Deva,17148,305308,1384,17148,211056,3411,516364
eng_Latn-jiv_Latn,12996,291238,27023,12996,216915,27277,508153
zho_Hani-uzb_Cyrl,37201,49329,59501,37201,457821,43696,507150
ceb_Latn-ukr_Cyrl,20672,291075,19650,20672,214673,19609,505748
fon_Latn-wol_Latn,23876,276128,14488,23876,229183,14154,505311
shp_Latn-spa_Latn,45775,206826,39138,45775,287617,39222,494443
cak_Latn-ceb_Latn,7629,302921,14823,7629,190196,6571,493117
ara_Arab-mlt_Latn,18120,242972,12737,18120,244826,14660,487798
ceb_Latn-djk_Latn,7565,189990,6545,7565,290215,17684,480205
dyu_Latn-kmb_Latn,25165,251688,12977,25165,227459,12467,479147
deu_Latn-wln_Latn,50314,204884,12300,50314,270206,11448,475090
deu_Latn-wol_Latn,29114,233291,11274,29114,238959,16174,472250
dyu_Latn-ssw_Latn,28526,298324,15674,28526,168774,14767,467098
ara_Arab-orm_Latn,24422,290688,14277,24422,174117,14245,464805
ceb_Latn-quc_Latn,7751,192603,6664,7751,265311,13776,457914
bam_Latn-orm_Latn,30262,257290,15773,30262,199098,16419,456388
eng_Latn-sme_Latn,63042,234964,81461,63042,221020,17957,455984
bre_Latn-nep_Deva,58390,241335,13883,58390,213969,10826,455304
ceb_Latn-msa_Latn,26560,231889,24206,26560,221768,20506,453657
zho_Hani-tat_Cyrl,25475,26599,54611,25475,426059,28287,452658
zho_Hani-kir_Cyrl,46611,60913,50027,46611,390288,25280,451201
cak_Latn-deu_Latn,7394,289000,14231,7394,159456,6237,448456
eng_Latn-glv_Latn,14937,216415,26520,14937,231958,9143,448373
ara_Arab-wln_Latn,49334,192300,10534,49334,253837,10399,446137
ara_Arab-fry_Latn,40742,208516,12725,40742,235186,14884,443702
cak_Latn-nep_Deva,7208,283325,13973,7208,158928,20,442253
deu_Latn-djk_Latn,7358,159739,6235,7358,278428,16967,438167
aze_Latn-lao_Laoo,21313,257608,17889,21313,179357,16028,436965
djk_Latn-nep_Deva,7182,273304,16677,7182,159332,21,432636
zho_Hani-jav_Latn,97927,104082,103718,97927,322798,13520,426880
deu_Latn-quc_Latn,7687,164575,6445,7687,261294,13588,425869
nep_Deva-quc_Latn,7522,163950,21,7522,256650,13404,420600
eng_Latn-arz_Arab,18753,212438,39529,18753,201243,21452,413681
ceb_Latn-ewe_Latn,7870,195105,6754,7870,216262,9596,411367
aka_Latn-kon_Latn,23036,222509,9982,23036,185839,8272,408348
ceb_Latn-mam_Latn,7694,190980,6608,7694,213271,11215,404251
aka_Latn-dyu_Latn,19101,208306,10521,19101,191037,10355,399343
deu_Latn-roh_Latn,10671,185628,12994,10671,213301,11624,398929
fry_Latn-nep_Deva,34729,199751,12853,34729,192394,4642,392145
amu_Latn-ceb_Latn,7800,197883,13934,7800,193111,6701,390994
ceb_Latn-guj_Gujr,7913,192376,6683,7913,197482,16443,389858
ara_Arab-lug_Latn,22453,240441,14819,22453,148013,16590,388454
deu_Latn-ewe_Latn,7945,168660,6822,7945,216002,9717,384662
aze_Latn-glg_Latn,19046,170872,17069,19046,213581,17122,384453
ceb_Latn-ppk_Latn,7693,190741,6655,7693,188618,13334,379359
ewe_Latn-nep_Deva,7704,211061,9398,7704,166895,21,377956
nep_Deva-wln_Latn,41307,164739,5334,41307,212258,9388,376997
ceb_Latn-rom_Latn,7873,195028,6759,7873,181835,8420,376863
deu_Latn-mam_Latn,7697,164244,6447,7697,212273,11209,376517
bho_Deva-kas_Arab,11710,190206,6641,11710,184881,1025,375087
mam_Latn-nep_Deva,7550,208410,10999,7550,163542,21,371952
ceb_Latn-est_Latn,8820,216085,7646,8820,151211,5259,367296
hne_Deva-kas_Arab,9671,183261,605,9671,183154,688,366415
ful_Latn-kmb_Latn,19092,167659,12719,19092,198103,12130,365762
ceb_Latn-wol_Latn,7849,194659,6740,7849,170288,8807,364947
amu_Latn-deu_Latn,7823,198074,13999,7823,166482,6572,364556
amu_Latn-nep_Deva,7667,194442,13734,7667,165764,21,360206
bam_Latn-kik_Latn,16924,202544,10163,16924,156676,9063,359220
aze_Latn-jav_Latn,41100,176720,14651,41100,182149,14790,358869
eng_Latn-ido_Latn,18103,183481,34485,18103,172437,15554,355918
ceb_Latn-kab_Latn,7865,194738,6749,7865,160631,7157,355369
jav_Latn-nep_Deva,36107,175637,16925,36107,178351,12324,353988
deu_Latn-ppk_Latn,7714,164442,6516,7714,188682,13354,353124
deu_Latn-ssw_Latn,14227,190303,8022,14227,161529,10288,351832
deu_Latn-rom_Latn,7962,168440,6629,7962,182682,8483,351122
nep_Deva-ppk_Latn,7578,163953,21,7578,185209,13088,349162
ban_Latn-min_Latn,19823,182326,11194,19823,166503,10190,348829
nep_Deva-kin_Latn,37000,208503,3919,37000,138300,6932,346803
nep_Deva-rom_Latn,7782,167430,21,7782,179148,8308,346578
nep_Deva-wol_Latn,10126,172772,128,10126,173604,8974,346376
zho_Hani-yor_Latn,22657,30915,25081,22657,314625,15674,345540
zho_Hani-bre_Latn,55578,90893,59890,55578,253054,19660,343947
crh_Latn-uig_Arab,24529,170713,17751,24529,172410,16820,343123
zho_Hani-snd_Arab,12994,13234,31563,12994,326703,11810,339937
eng_Latn-mwl_Latn,10409,164598,21759,10409,174728,11227,339326
deu_Latn-kab_Latn,8575,170889,6917,8575,163632,7506,334521
ceb_Latn-ssw_Latn,7793,192987,6687,7793,138214,8624,331201
ceb_Latn-lav_Latn,8169,196779,6898,8169,133262,6746,330041
zho_Hani-uig_Arab,16912,17199,36440,16912,312177,4762,329376
ceb_Latn-eus_Latn,8178,196458,6892,8178,132636,6724,329094
aka_Latn-bam_Latn,14266,168842,7606,14266,160032,7793,328874
kab_Latn-nep_Deva,7811,158226,7064,7811,167222,27,325448
aka_Latn-kmb_Latn,15566,177849,7945,15566,145686,6573,323535
zho_Hani-cak_Latn,7831,7831,8559,7831,313968,15379,321799
nep_Deva-ssw_Latn,9753,174395,447,9753,144434,9035,318829
ceb_Latn-wal_Latn,7708,191332,6608,7708,125996,8893,317328
zho_Hani-wln_Latn,43088,68418,49254,43088,246830,10150,315248
zho_Hani-djk_Latn,7869,7869,8607,7869,306650,18643,314519
eng_Latn-aym_Latn,10330,182268,21494,10330,130936,10592,313204
eng_Latn-csb_Latn,31604,159325,42285,31604,151470,9286,310795
ceb_Latn-quw_Latn,7849,194040,6721,7849,115919,10830,309959
ceb_Latn-chr_Cher,7829,193856,6711,7829,115526,6808,309382
deu_Latn-fao_Latn,16333,163276,17278,16333,145494,17116,308770
zho_Hani-ibo_Latn,21825,29164,24110,21825,277334,14488,306498
ara_Arab-ori_Orya,17928,157083,8266,17928,148874,7176,305957
ara_Arab-bak_Cyrl,14999,167866,15925,14999,134156,15834,302022
ast_Latn-deu_Latn,30252,165304,12362,30252,136517,13314,301821
ceb_Latn-syr_Syrc,7798,192511,6683,7798,108340,0,300851
ceb_Latn-cha_Latn,7221,162053,6330,7221,134359,6418,296412
eng_Latn-bar_Latn,16699,151205,35075,16699,141411,18296,292616
deu_Latn-sme_Latn,38490,148244,12986,38490,143839,10390,292083
ceb_Latn-shi_Latn,7641,189100,6569,7641,102691,10432,291791
deu_Latn-wal_Latn,7750,165215,6494,7750,126535,8955,291750
ara_Arab-ewe_Latn,7177,100887,8248,7177,188071,8485,288958
zho_Hani-div_Thaa,12717,12843,31243,12717,275225,26954,288068
amu_Latn-ara_Arab,7439,184372,13168,7439,103647,8584,288019
nep_Deva-wal_Latn,7592,163744,20,7592,123969,8780,287713
ara_Arab-ssw_Latn,12886,128530,10633,12886,157136,10246,285666
ceb_Latn-zul_Latn,7769,190637,6692,7769,94910,6146,285547
ara_Arab-mam_Latn,7049,98954,8127,7049,186585,9966,285539
ara_Arab-rom_Latn,7795,107469,8912,7795,177901,8274,285370
chr_Cher-deu_Latn,7932,116416,6931,7932,168423,6631,284839
ast_Latn-nep_Deva,32340,149656,11200,32340,134895,8108,284551
bjn_Latn-min_Latn,25378,152717,14149,25378,131591,13378,284308
deu_Latn-quw_Latn,7890,167637,6588,7890,116474,10909,284111
eng_Latn-pcm_Latn,6276,137124,12216,6276,145721,10182,282845
ceb_Latn-hye_Armn,6486,166352,5887,6486,114197,3673,280549
ara_Arab-quc_Latn,6094,87058,7148,6094,193154,10423,280212
chr_Cher-nep_Deva,7727,113852,6754,7727,166088,23,279940
nep_Deva-quw_Latn,7701,165507,21,7701,113955,10663,279462
zho_Hani-quc_Latn,7877,7877,8607,7877,271309,14086,279186
bam_Latn-kmb_Latn,13256,146761,7656,13256,132260,7103,279021
deu_Latn-syr_Syrc,8016,168049,6615,8016,109685,2,277734
ara_Arab-ppk_Latn,7322,101897,8473,7322,173094,12354,274991
cha_Latn-deu_Latn,7240,134705,6439,7240,138672,6256,273377
zho_Hani-fry_Latn,35753,55248,44682,35753,218001,13646,273249
zho_Hani-nya_Latn,18184,25139,19854,18184,246433,16240,271572
nep_Deva-syr_Syrc,7730,164162,21,7730,106625,1,270787
ara_Arab-kab_Latn,8171,109589,9109,8171,161018,7226,270607
asm_Beng-kas_Arab,19079,120373,22570,19079,149690,2327,270063
deu_Latn-shi_Latn,7793,165925,6526,7793,104021,10619,269946
cha_Latn-nep_Deva,7109,132376,6325,7109,136243,3,268619
awa_Deva-mag_Deva,13675,139106,1871,13675,129307,1699,268413
nep_Deva-sme_Latn,33110,149381,8037,33110,118023,9143,267404
ceb_Latn-jiv_Latn,6457,159250,5599,6457,107966,13571,267216
aka_Latn-kik_Latn,13930,154495,6759,13930,111528,5603,266023
nep_Deva-shi_Latn,7629,163992,20,7629,101761,10380,265753
bam_Latn-ssw_Latn,15602,167238,9077,15602,94539,8197,261777
aka_Latn-ful_Latn,14232,148207,7514,14232,111614,7176,259821
arg_Latn-deu_Latn,14973,134352,13691,14973,123968,14706,258320
eng_Latn-ina_Latn,19127,125048,33145,19127,132260,11757,257308
aka_Latn-ssw_Latn,19247,165985,8369,19247,90816,6635,256801
mai_Deva-nep_Deva,28087,124686,8966,28087,123402,7340,248088
deu_Latn-jiv_Latn,6512,138904,5533,6512,108356,13636,247260
diq_Latn-pus_Arab,15085,103898,6548,15085,139995,7328,243893
jiv_Latn-nep_Deva,6387,106155,13353,6387,135617,15,241772
cat_Latn-ceb_Latn,15045,123529,15538,15045,116435,15054,239964
ara_Arab-djk_Latn,4848,72653,5784,4848,166113,10201,238766
aze_Latn-eus_Latn,15618,117925,7109,15618,120396,7502,238321
deu_Latn-glv_Latn,9000,111931,4888,9000,125836,4828,237767
nep_Deva-ori_Orya,22497,115703,2651,22497,117545,3189,233248
zho_Hani-zul_Latn,20928,24244,23083,20928,208653,14055,232897
ara_Arab-wal_Latn,7716,106583,8884,7716,125429,8891,232012
nep_Deva-uzb_Latn,30404,121345,3693,30404,108230,6466,229575
ben_Beng-sat_Olck,19605,129468,22915,19605,99771,1478,229239
ara_Arab-cak_Latn,4596,67375,5344,4596,159132,8068,226507
zho_Hani-ewe_Latn,7936,7936,8675,7936,218420,9713,226356
ara_Arab-chr_Cher,7950,109168,9090,7950,116442,6940,225610
ara_Arab-quw_Latn,7914,108810,9063,7914,116610,10924,225420
aze_Latn-nob_Latn,7975,100179,6439,7975,124964,6351,225143
nep_Deva-hbs_Latn,10462,107369,656,10462,117300,12642,224669
zho_Hani-mam_Latn,7777,7777,8494,7777,216616,11411,224393
ara_Arab-cha_Latn,7211,86600,9286,7211,134198,6418,220798
ara_Arab-syr_Syrc,8002,109152,9074,8002,109681,1,218833
aze_Latn-epo_Latn,13079,101802,5291,13079,116527,5149,218329
ara_Arab-shi_Latn,7912,108610,9042,7912,104527,10720,213137
csb_Latn-deu_Latn,21428,106033,6883,21428,104909,7172,210942
glv_Latn-nep_Deva,7331,112377,4282,7331,97562,388,209939
arz_Arab-deu_Latn,11743,103976,13566,11743,105720,13278,209696
fas_Arab-ori_Orya,9557,108429,5996,9557,99570,4802,207999
zho_Hani-amu_Latn,7854,7854,8583,7854,199608,14060,207462
afr_Latn-yid_Hebr,15672,109341,10811,15672,95739,13519,205080
eng_Latn-hsb_Latn,22825,106467,30151,22825,98280,6378,204747
zho_Hani-wol_Latn,14042,14284,14923,14042,186643,9776,200927
zho_Hani-ppk_Latn,7773,7773,8508,7773,192238,13592,200011
ara_Arab-ast_Latn,21653,91443,9291,21653,108251,10127,199694
ara_Arab-csb_Latn,20601,99676,5657,20601,97339,5799,197015
fra_Latn-mos_Latn,3987,99527,3901,3987,97029,3942,196556
ara_Arab-jiv_Latn,6478,88773,7545,6478,106495,13427,195268
ara_Arab-glv_Latn,8265,74091,6439,8265,120841,4673,194932
deu_Latn-gla_Latn,12255,89294,5067,12255,104064,4358,193358
zho_Hani-rom_Latn,7952,7953,8693,7952,183215,8489,191168
ceb_Latn-glv_Latn,3997,96824,3456,3997,92995,3409,189819
deu_Latn-gom_Deva,10690,100077,11915,10690,89247,10229,189324
diq_Latn-fas_Arab,9549,86686,5189,9549,94777,4591,181463
csb_Latn-nep_Deva,19355,87862,5633,19355,93326,2560,181188
deu_Latn-ful_Latn,17159,83811,7675,17159,96477,12205,180288
diq_Latn-kur_Latn,13690,91179,6204,13690,88655,7185,179834
crh_Latn-nep_Deva,22405,85176,4192,22405,91867,1480,177043
eng_Latn-prs_Arab,4316,82917,9406,4316,93306,5168,176223
zho_Hani-pus_Arab,27186,32493,30499,27186,142237,5375,174730
aze_Latn-gle_Latn,11490,76754,3271,11490,96628,3119,173382
zho_Hani-kab_Latn,8081,8254,8827,8081,161789,7219,170043
diq_Latn-tgk_Cyrl,13539,88341,5693,13539,79022,5987,167363
nep_Deva-uig_Arab,19115,87154,1644,19115,76950,3503,164104
ara_Arab-tir_Ethi,5536,76766,4409,5536,83770,824,160536
eng_Latn-ckb_Arab,7658,83513,12063,7658,76710,3691,160223
ara_Arab-kin_Latn,22471,92486,5516,22471,66247,3531,158733
mlt_Latn-nep_Deva,5937,77254,3100,5937,78905,1190,156159
aze_Latn-fil_Latn,4825,65985,4347,4825,88571,4298,154556
zho_Hani-ssw_Latn,9855,9947,10637,9855,144469,8927,154416
eng_Latn-jbo_Latn,12747,70232,25192,12747,82696,3932,152928
deu_Latn-ori_Orya,17055,73533,3431,17055,77667,1416,151200
eng_Latn-tlh_Latn,13433,89160,27475,13433,60621,11614,149781
eng_Latn-din_Latn,3069,70362,6476,3069,78833,3291,149195
eng_Latn-tuk_Latn,13091,82030,25423,13091,66855,9381,148885
deu_Latn-hsb_Latn,15648,74687,5681,15648,69954,4902,144641
zho_Hani-cha_Latn,7231,7231,7923,7231,134632,6434,141863
zho_Hani-wal_Latn,7755,7755,8459,7755,126674,8966,134429
deu_Latn-ibo_Latn,3999,62572,4045,3999,69858,3925,132430
zho_Hani-glv_Latn,8393,8773,9934,8393,123508,4735,132281
ara_Arab-hsb_Latn,14251,68650,4327,14251,63512,4373,132162
zho_Hani-csb_Latn,19448,32866,23249,19448,97445,5969,130311
zho_Hani-lao_Laoo,19280,26837,20618,19280,102436,6499,129273
arg_Latn-nep_Deva,14024,69130,2288,14024,58801,916,127931
zho_Hani-quw_Latn,7927,7927,8669,7927,116791,10947,124718
zho_Hani-chr_Cher,7955,7958,8697,7955,116586,6945,124544
aze_Latn-mlt_Latn,3687,59057,2978,3687,63757,2925,122814
zho_Hani-syr_Syrc,8010,8011,8751,8010,109776,1,117787
zho_Hani-jiv_Latn,6555,6555,7191,6555,109327,13759,115882
ara_Arab-nso_Latn,9474,46660,2891,9474,68567,2553,115227
hsb_Latn-nep_Deva,12006,54548,3723,12006,60127,1506,114675
zho_Hani-shi_Latn,7906,7906,8641,7906,104618,10722,112524
aze_Latn-crh_Latn,14697,54944,2644,14697,57181,2703,112125
ara_Arab-gla_Latn,7674,43766,3141,7674,65999,2502,109765
eng_Latn-lfn_Latn,7779,50463,15838,7779,55525,6674,105988
deu_Latn-nso_Latn,8988,44821,1908,8988,60103,1988,104924
zho_Hani-bak_Cyrl,10402,10691,20742,10402,88373,10850,99064
ara_Arab-asm_Beng,14011,47537,2094,14011,50261,15628,97798
aze_Latn-lat_Latn,1742,47594,1308,1742,49006,1571,96600
deu_Latn-tsn_Latn,19636,47956,2731,19636,47702,2731,95658
nep_Deva-nso_Latn,7053,40090,1460,7053,54736,1993,94826
eng_Latn-crh_Latn,10207,47625,12312,10207,45534,1905,93159
awa_Deva-sat_Olck,3736,57791,529,3736,32624,347,90415
zho_Hani-hsb_Latn,13937,25403,16652,13937,64551,4268,89954
arg_Latn-aze_Latn,10766,49235,1282,10766,36316,1783,85551
deu_Latn-ina_Latn,7243,40322,2577,7243,44668,2578,84990
ara_Arab-yid_Hebr,8157,38775,2346,8157,44920,2066,83695
gla_Latn-nep_Deva,4823,42935,1402,4823,35361,430,78296
deu_Latn-lim_Latn,8518,38746,2166,8518,38114,2274,76860
aze_Latn-nso_Latn,6215,28260,1581,6215,46357,1565,74617
asm_Beng-aze_Latn,9877,40572,16069,9877,33157,1499,73729
awa_Deva-kas_Arab,3841,37448,535,3841,34415,425,71863
aze_Latn-wln_Latn,9685,30493,1692,9685,39608,1533,70101
guj_Gujr-sat_Olck,4134,33361,2606,4134,33531,331,66892
crh_Latn-deu_Latn,7600,32679,1173,7600,32351,1172,65030
deu_Latn-lug_Latn,6227,28792,1793,6227,34359,1899,63151
asm_Beng-sat_Olck,5053,33752,5920,5053,28626,441,62378
ara_Arab-ltz_Latn,7022,29666,1580,7022,29880,1743,59546
hin_Deva-sat_Olck,5383,31649,328,5383,27608,299,59257
ara_Arab-lim_Latn,7471,28466,1140,7471,29348,1209,57814
deu_Latn-fur_Latn,5287,26616,1280,5287,30807,1358,57423
aze_Latn-bre_Latn,8700,26025,1614,8700,31149,2162,57174
ara_Arab-tsn_Latn,12333,27729,761,12333,28173,1290,55902
eng_Latn-cor_Latn,5789,27464,10787,5789,27549,4812,55013
bho_Deva-sat_Olck,3653,32425,581,3653,21177,375,53602
aze_Latn-nno_Latn,6975,24717,1476,6975,26554,1542,51271
ast_Latn-aze_Latn,6984,28421,1031,6984,22790,950,51211
zho_Hani-yue_Hani,25582,25582,39650,25582,25582,2792,51164
deu_Latn-lin_Latn,5775,24128,1097,5775,26451,996,50579
aze_Latn-dzo_Tibt,10065,30958,1799,10065,19448,716,50406
fur_Latn-nep_Deva,4611,27112,1301,4611,23285,432,50397
ltz_Latn-nep_Deva,6853,24737,1637,6853,25323,905,50060
lim_Latn-nep_Deva,5821,23757,1012,5821,24074,437,47831
eng_Latn-ven_Latn,1628,22879,3125,1628,24841,1178,47720
aze_Latn-ori_Orya,7064,21863,960,7064,25679,610,47542
ara_Arab-fur_Latn,4730,20412,1224,4730,26351,1186,46763
zho_Hani-crh_Latn,7939,11131,8945,7939,35401,1421,46532
aze_Latn-lim_Latn,5653,21132,926,5653,23429,951,44561
ara_Arab-aym_Latn,1600,23331,1179,1600,20921,1351,44252
zho_Hani-gla_Latn,5028,5408,5441,5028,38388,492,43796
deu_Latn-tir_Ethi,2660,20692,1490,2660,22687,351,43379
eng_Latn-ile_Latn,3812,21215,8228,3812,20902,3074,42117
aze_Latn-kin_Latn,6275,24319,1535,6275,17472,1108,41791
zho_Hani-asm_Beng,7699,10946,8498,7699,30667,8391,41613
eng_Latn-mhr_Cyrl,5201,21639,6935,5201,19677,1602,41316
aze_Latn-fur_Latn,4005,17588,1145,4005,23523,1120,41111
aym_Latn-deu_Latn,1507,17355,1600,1507,23198,1629,40553
aze_Latn-oci_Latn,6726,18134,1133,6726,22282,1259,40416
zho_Hani-lim_Latn,7444,8678,8278,7444,31163,1134,39841
eng_Latn-dtp_Latn,3117,19350,6393,3117,19466,2452,38816
deu_Latn-mhr_Cyrl,4677,19424,1009,4677,17787,1500,37211
ara_Arab-tuk_Latn,4001,19197,1171,4001,17910,1471,37107
deu_Latn-ile_Latn,3576,17413,2987,3576,18234,2974,35647
zho_Hani-ful_Latn,4462,4881,4928,4462,28637,810,33518
ceb_Latn-gla_Latn,676,16219,571,676,15467,71,31686
ara_Arab-lin_Latn,3535,14961,463,3535,16226,422,31187
aze_Latn-mai_Deva,5083,14432,679,5083,16654,647,31086
aze_Latn-glv_Latn,3065,12830,917,3065,17755,788,30585
nep_Deva-yid_Hebr,4717,15879,503,4717,14649,105,30528
ara_Arab-ina_Latn,3812,13941,509,3812,15762,493,29703
deu_Latn-orm_Latn,5699,15141,837,5699,13749,659,28890
eng_Latn-cbk_Latn,2499,13913,5072,2499,14787,1897,28700
deu_Latn-tuk_Latn,3286,15512,854,3286,12811,1082,28323
zho_Hani-fil_Latn,1866,1927,2405,1866,26233,1703,28160
zho_Hani-kin_Latn,3486,4978,5366,3486,21972,2713,26950
zho_Hani-tsn_Latn,7840,8174,7983,7840,17857,749,26031
eng_Latn-vol_Latn,2801,14762,5647,2801,11182,2248,25944
eng_Latn-ang_Latn,4330,12685,4596,4330,12470,183,25155
div_Thaa-nep_Deva,3036,10982,304,3036,12212,127,23194
eng_Latn-aka_Latn,1003,11701,1771,1003,11146,1202,22847
deu_Latn-run_Latn,2707,13629,1861,2707,8708,1914,22337
deu_Latn-ido_Latn,2675,11268,1355,2675,10788,1359,22056
eng_Latn-dzo_Tibt,3464,13278,4044,3464,8511,466,21789
deu_Latn-jbo_Latn,2113,9886,1128,2113,11437,672,21323
deu_Latn-tlh_Latn,2101,13178,1623,2101,8047,1636,21225
aze_Latn-fry_Latn,3458,10226,424,3458,10333,420,20559
eng_Latn-bis_Latn,1195,10097,3114,1195,10220,1699,20317
eng_Latn-zsm_Latn,1442,10593,2967,1442,9612,1179,20205
aze_Latn-gla_Latn,2886,8169,432,2886,11981,528,20150
eng_Latn-bam_Latn,1385,10826,3202,1385,9071,1539,19897
zho_Hani-nan_Latn,686,905,1529,686,18723,836,19628
zho_Hani-nso_Latn,1914,1996,2596,1914,17066,710,19062
eng_Latn-tet_Latn,679,9452,1322,679,9246,660,18698
aze_Latn-nds_Latn,4102,9432,545,4102,8984,653,18416
eng_Latn-pam_Latn,1637,9723,3312,1637,8517,1399,18240
zho_Hani-fur_Latn,2725,2914,3198,2725,15048,682,17962
fil_Latn-nep_Deva,968,9198,567,968,8757,82,17955
aze_Latn-wol_Latn,3763,8820,711,3763,9054,831,17874
zho_Hani-ina_Latn,2491,3130,2747,2491,14405,497,17535
aze_Latn-tsn_Latn,3891,8381,410,3891,8740,466,17121
eng_Latn-frp_Latn,2882,8464,3075,2882,8316,145,16780
nep_Deva-tuk_Latn,2474,8911,345,2474,7703,468,16614
ang_Latn-deu_Latn,2645,7731,72,2645,8460,90,16191
aze_Latn-ssw_Latn,2087,8347,540,2087,7694,507,16041
eng_Latn-kha_Latn,1397,7545,2828,1397,8456,1026,16001
zho_Hani-tuk_Latn,3030,3342,3640,3030,12302,973,15644
zho_Hani-lug_Latn,2715,3346,2869,2715,11321,438,14667
deu_Latn-cor_Latn,1611,7202,953,1611,7317,1010,14519
aze_Latn-tuk_Latn,2126,7224,533,2126,7034,488,14258
mhr_Cyrl-nep_Deva,1687,6487,503,1687,7390,233,13877
bod_Tibt-deu_Latn,1497,6526,288,1497,7346,437,13872
eng_Latn-bod_Tibt,1468,7606,2000,1468,6118,332,13724
eng_Latn-sco_Latn,770,6878,1393,770,6561,490,13439
eng_Latn-mad_Latn,229,7263,615,229,6048,465,13311
aze_Latn-hbs_Latn,350,6061,376,350,7187,379,13248
aze_Latn-ful_Latn,2508,6223,450,2508,6694,468,12917
deu_Latn-kon_Latn,1791,6184,105,1791,6628,150,12812
eng_Latn-wuu_Hani,1670,8500,3437,1670,4214,105,12714
nep_Deva-tat_Latn,2100,6883,199,2100,5724,329,12607
arg_Latn-ara_Arab,1303,6916,585,1303,5449,428,12365
nep_Deva-tsn_Latn,2990,5946,84,2990,6300,161,12246
ara_Arab-kon_Latn,1712,5723,139,1712,6377,156,12100
ara_Arab-ckb_Arab,2374,6550,362,2374,5282,119,11832
deu_Latn-sco_Latn,819,5508,447,819,6111,489,11619
deu_Latn-kua_Latn,697,5866,1086,697,5716,1048,11582
cre_Latn-eng_Latn,1016,4664,487,1016,6899,484,11563
deu_Latn-frp_Latn,1821,5826,63,1821,5415,41,11241
eng_Latn-roh_Latn,677,5797,1375,677,5438,728,11235
ara_Arab-bod_Tibt,1307,6345,539,1307,4818,238,11163
zho_Hani-arg_Latn,1883,1953,2024,1883,8927,148,10880
eng_Latn-inh_Cyrl,403,5546,852,403,5180,394,10726
eng_Latn-kua_Latn,601,5314,1783,601,4893,907,10207
ara_Arab-ile_Latn,684,5039,792,684,5168,548,10207
eng_Latn-grc_Grek,877,5617,1571,877,4458,558,10075
ara_Arab-san_Deva,1637,5580,304,1637,4429,222,10009
deu_Latn-inh_Cyrl,387,4945,350,387,5060,390,10005
lug_Latn-nep_Deva,1750,5075,160,1750,4826,113,9901
ara_Arab-inh_Cyrl,438,4553,323,438,5338,401,9891
aze_Latn-inh_Cyrl,396,4727,403,396,5053,386,9780
aze_Latn-mhr_Cyrl,1741,4663,302,1741,4564,343,9227
eng_Latn-oss_Cyrl,1311,4951,1621,1311,4197,300,9148
hne_Deva-sat_Olck,602,4894,74,602,4212,85,9106
aze_Latn-ina_Latn,1673,4223,50,1673,4800,44,9023
zho_Hani-kon_Latn,1750,2253,1846,1750,6756,169,9009
nep_Deva-snd_Arab,1416,4510,105,1416,4478,121,8988
ful_Latn-nep_Deva,1719,4546,276,1719,4313,156,8859
ang_Latn-nep_Deva,1653,4357,7,1653,4416,8,8773
kon_Latn-nep_Deva,1300,4510,89,1300,4107,20,8617
eng_Latn-zza_Latn,1306,4362,1891,1306,4195,440,8557
deu_Latn-lfn_Latn,574,3975,522,574,4532,526,8507
ina_Latn-nep_Deva,1491,4394,43,1491,4098,19,8492
deu_Latn-san_Deva,1558,4828,146,1558,3623,123,8451
deu_Latn-mad_Latn,142,4510,152,142,3719,162,8229
aze_Latn-kon_Latn,1301,3709,48,1301,4374,74,8083
ara_Arab-sco_Latn,700,3590,129,700,4472,335,8062
eng_Latn-ace_Latn,1260,4035,1402,1260,3996,105,8031
fao_Latn-nep_Deva,1114,3756,85,1114,4156,59,7912
ara_Arab-cor_Latn,1103,3782,259,1103,4089,255,7871
bod_Tibt-nep_Deva,1381,3256,137,1381,4567,137,7823
deu_Latn-srd_Latn,841,3654,176,841,4121,170,7775
ara_Arab-fao_Latn,1097,3926,166,1097,3753,146,7679
ara_Arab-dzo_Tibt,1168,5040,256,1168,2584,25,7624
aze_Latn-bod_Tibt,1338,4357,413,1338,3177,194,7534
ara_Arab-ido_Latn,1143,3817,151,1143,3612,147,7429
eng_Latn-lad_Latn,861,3741,1731,861,3679,700,7420
deu_Latn-dsb_Latn,727,3949,568,727,3453,570,7402
zho_Hani-lin_Latn,1980,2051,2080,1980,5159,114,7210
ang_Latn-aze_Latn,1370,3636,6,1370,3567,16,7203
deu_Latn-wuu_Hani,1106,4804,1179,1106,2302,36,7106
deu_Latn-tso_Latn,711,3214,145,711,3813,143,7027
aze_Latn-ido_Latn,1250,3381,144,1250,3499,122,6880
deu_Latn-szl_Latn,693,3625,209,693,3131,193,6756
ace_Latn-deu_Latn,953,3306,92,953,3396,103,6702
aze_Latn-lug_Latn,998,3122,218,998,3492,362,6614
deu_Latn-oss_Cyrl,994,3490,190,994,3119,203,6609
ido_Latn-nep_Deva,1138,3150,119,1138,3399,68,6549
zho_Hani-tir_Ethi,870,1018,1158,870,5477,39,6495
aze_Latn-lin_Latn,1340,3060,168,1340,3296,298,6356
zho_Hani-orm_Latn,1967,2040,2082,1967,4235,186,6275
eng_Latn-chv_Cyrl,872,3404,1325,872,2770,375,6174
eng_Latn-mfe_Latn,271,3149,541,271,2847,235,5996
ara_Arab-szl_Latn,638,3105,185,638,2884,188,5989
aze_Latn-shn_Mymr,854,3201,71,854,2742,33,5943
ckb_Arab-nep_Deva,842,2791,91,842,3079,74,5870
ara_Arab-tso_Latn,624,2498,138,624,3349,123,5847
ace_Latn-ara_Arab,866,2849,86,866,2935,114,5784
dzo_Tibt-nep_Deva,801,1889,25,801,3872,29,5761
inh_Cyrl-nep_Deva,220,2882,227,220,2874,6,5756
ara_Arab-oss_Cyrl,894,2990,195,894,2755,191,5745
deu_Latn-mfe_Latn,235,2776,205,235,2778,222,5554
zho_Hani-cor_Latn,1056,1372,1188,1056,4169,209,5541
aze_Latn-mfe_Latn,232,2585,220,232,2789,222,5374
aze_Latn-frp_Latn,833,2650,76,833,2701,41,5351
zho_Hani-bod_Tibt,1274,1462,1566,1274,3852,118,5314
bbc_Latn-eng_Latn,100,2741,211,100,2530,192,5271
aze_Latn-szl_Latn,572,2613,172,572,2626,170,5239
eng_Latn-nij_Latn,100,2741,323,100,2476,301,5217
aze_Latn-cor_Latn,776,2468,238,776,2693,358,5161
aze_Latn-orm_Latn,1438,2676,115,1438,2474,110,5150
aze_Latn-yid_Hebr,321,2148,168,321,2923,215,5071
deu_Latn-ltg_Latn,448,2785,157,448,2283,165,5068
ceb_Latn-mkd_Cyrl,312,2572,168,312,2338,153,4910
aze_Latn-oss_Cyrl,737,2489,165,737,2341,155,4830
ara_Arab-mfe_Latn,236,2218,169,236,2590,208,4808
bbc_Latn-ind_Latn,100,2261,191,100,2530,192,4791
ind_Latn-nij_Latn,100,2261,191,100,2476,189,4737
eng_Latn-pms_Latn,351,2204,650,351,2476,249,4680
aze_Latn-srd_Latn,626,2149,129,626,2527,89,4676
aze_Latn-sme_Latn,1300,2523,127,1300,2144,66,4667
lin_Latn-nep_Deva,918,2484,67,918,2146,51,4630
ind_Latn-mad_Latn,100,2261,191,100,2368,197,4629
ban_Latn-ind_Latn,100,2261,191,100,2338,193,4599
ace_Latn-ind_Latn,100,2261,191,100,2338,188,4599
ceb_Latn-glg_Latn,440,2216,336,440,2369,226,4585
deu_Latn-vec_Latn,440,2204,181,440,2327,113,4531
ind_Latn-min_Latn,100,2261,191,100,2267,191,4528
ind_Latn-jav_Latn,100,2261,191,100,2266,191,4527
ind_Latn-sun_Latn,100,2261,191,100,2258,190,4519
ara_Arab-ltg_Latn,363,2327,129,363,2192,155,4519
nep_Deva-tso_Latn,499,1974,44,499,2303,75,4277
zho_Hani-mlt_Latn,449,809,623,449,3456,315,4265
zho_Hani-oss_Cyrl,872,1202,1025,872,2981,198,4183
deu_Latn-tet_Latn,210,2035,105,210,2095,95,4130
nep_Deva-orm_Latn,1140,2127,46,1140,1965,61,4092
ceb_Latn-fas_Arab,238,1646,110,238,2288,150,3934
zho_Hani-tso_Latn,596,653,711,596,3190,110,3843
aze_Latn-tir_Ethi,566,1856,132,566,1909,89,3765
ara_Arab-mhr_Cyrl,626,1989,135,626,1760,101,3749
nep_Deva-tir_Ethi,517,1908,58,517,1821,48,3729
ara_Arab-srd_Latn,361,1621,126,361,2069,97,3690
zho_Hani-szl_Latn,634,841,759,634,2831,173,3672
ceb_Latn-nob_Latn,324,1811,137,324,1805,103,3616
aze_Latn-csb_Latn,732,1915,128,732,1650,58,3565
deu_Latn-dzo_Tibt,626,2119,87,626,1355,37,3474
ara_Arab-tlh_Latn,168,1860,105,168,1570,185,3430
ara_Arab-vec_Latn,354,1591,101,354,1780,75,3371
eng_Latn-swh_Latn,382,1969,790,382,1371,326,3340
aze_Latn-ltg_Latn,242,1636,105,242,1645,134,3281
eng_Latn-xal_Cyrl,312,1812,601,312,1426,235,3238
nep_Deva-szl_Latn,352,1719,18,352,1512,88,3231
zho_Hani-srd_Latn,381,610,470,381,2564,116,3174
deu_Latn-frr_Latn,278,1557,226,278,1535,225,3092
bos_Latn-ceb_Latn,320,1500,190,320,1580,180,3080
zho_Hani-inh_Cyrl,221,221,425,221,2841,226,3062
ben_Beng-ceb_Latn,296,1549,410,296,1500,158,3049
zho_Hani-vec_Latn,393,770,497,393,2204,104,2974
ceb_Latn-tam_Taml,275,1479,120,275,1456,163,2935
zho_Hani-sco_Latn,504,583,617,504,2293,138,2876
ace_Latn-nep_Deva,395,1394,53,395,1480,38,2874
aze_Latn-tso_Latn,355,1218,55,355,1619,48,2837
deu_Latn-que_Latn,543,1572,22,543,1264,19,2836
aze_Latn-san_Deva,566,1547,87,566,1215,52,2762
deu_Latn-grc_Grek,282,1361,101,282,1376,103,2737
ara_Arab-jbo_Latn,513,1226,31,513,1407,86,2633
deu_Latn-sot_Latn,176,1159,53,176,1400,52,2559
aze_Latn-sco_Latn,348,1212,60,348,1320,54,2532
nep_Deva-sco_Latn,339,1287,15,339,1227,51,2514
ceb_Latn-urd_Arab,90,1070,80,90,1357,59,2427
zho_Hani-dzo_Tibt,680,722,897,680,1697,4,2419
eng_Latn-nov_Latn,234,1210,476,234,1201,192,2411
aym_Latn-aze_Latn,115,1201,402,115,1169,133,2370
cor_Latn-nep_Deva,350,1152,18,350,1201,30,2353
ast_Latn-ceb_Latn,125,1152,157,125,1185,142,2337
ltg_Latn-nep_Deva,186,1071,65,186,1263,12,2334
deu_Latn-zza_Latn,441,1251,12,441,1077,13,2328
eng_Latn-frr_Latn,197,1213,400,197,1112,168,2325
nep_Deva-srd_Latn,284,1159,45,284,1156,42,2315
nep_Deva-oss_Cyrl,312,1265,15,312,1025,58,2290
zho_Hani-ltg_Latn,280,413,404,280,1863,134,2276
deu_Latn-lad_Latn,263,1118,222,263,1097,222,2215
zho_Hani-jbo_Latn,479,680,494,479,1519,84,2199
ara_Arab-roh_Latn,81,958,33,81,1200,53,2158
aze_Latn-vec_Latn,228,1013,58,228,1133,42,2146
ceb_Latn-kur_Latn,111,1055,135,111,1083,175,2138
eng_Latn-awa_Deva,279,1042,559,279,1087,0,2129
aze_Latn-ceb_Latn,120,940,124,120,1154,150,2094
eng_Latn-ton_Latn,101,1019,205,101,1024,227,2043
aze_Latn-jbo_Latn,340,876,57,340,1110,91,1986
eng_Latn-lld_Latn,180,932,220,180,1046,34,1978
deu_Latn-vol_Latn,215,1084,164,215,819,172,1903
zho_Hani-aym_Latn,168,170,482,168,1725,255,1895
ceb_Latn-oci_Latn,80,903,66,80,980,62,1883
eng_Latn-avk_Latn,170,1035,344,170,842,127,1877
nep_Deva-vec_Latn,197,936,25,197,931,32,1867
jbo_Latn-nep_Deva,273,961,75,273,865,34,1826
ceb_Latn-kaz_Cyrl,87,1062,77,87,759,90,1821
ceb_Latn-mon_Cyrl,96,1001,87,96,793,82,1794
aze_Latn-fao_Latn,276,900,25,276,882,23,1782
deu_Latn-kal_Latn,256,939,55,256,820,23,1759
deu_Latn-pap_Latn,220,816,122,220,928,70,1744
aym_Latn-nep_Deva,90,651,40,90,1039,4,1690
eng_Latn-gsw_Latn,216,846,435,216,837,157,1683
ara_Arab-bis_Latn,45,634,35,45,1027,35,1661
bis_Latn-deu_Latn,40,935,33,40,684,39,1619
ceb_Latn-ltg_Latn,68,859,67,68,713,79,1572
deu_Latn-shn_Mymr,273,879,21,273,680,18,1559
ara_Arab-shn_Mymr,262,870,30,262,655,18,1525
ceb_Latn-uzb_Latn,80,840,64,80,682,71,1522
deu_Latn-pms_Latn,104,673,30,104,849,34,1522
zho_Hani-ckb_Arab,140,202,187,140,1296,60,1498
ceb_Latn-uig_Arab,233,753,65,233,737,63,1490
deu_Latn-fij_Latn,70,789,77,70,698,176,1487
ara_Arab-tet_Latn,148,705,58,148,779,86,1484
bel_Cyrl-ceb_Latn,62,714,59,62,752,58,1466
ara_Arab-zsm_Latn,125,642,104,125,821,105,1463
ceb_Latn-hbs_Latn,61,813,42,61,602,46,1415
eng_Latn-cre_Latn,39,783,94,39,623,35,1406
ara_Arab-grc_Grek,171,621,20,171,753,21,1374
aze_Latn-ckb_Arab,198,690,35,198,668,28,1358
ara_Arab-sot_Latn,117,626,26,117,728,20,1354
nep_Deva-san_Deva,261,795,31,261,550,18,1345
ara_Arab-kal_Latn,198,723,23,198,603,15,1326
deu_Latn-lld_Latn,113,617,13,113,695,15,1312
ceb_Latn-kat_Geor,57,696,54,57,614,62,1310
ceb_Latn-tat_Cyrl,59,783,61,59,526,52,1309
eng_Latn-nav_Latn,110,692,254,110,607,94,1299
ara_Arab-pap_Latn,187,616,23,187,678,14,1294
eng_Latn-zlm_Latn,98,669,202,98,609,70,1278
eng_Latn-dsb_Latn,170,709,292,170,564,109,1273
cnh_Latn-deu_Latn,47,587,44,47,653,45,1240
bre_Latn-ceb_Latn,121,656,74,121,583,64,1239
ceb_Latn-nno_Latn,134,621,60,134,595,26,1216
ceb_Latn-pam_Latn,117,566,165,117,646,79,1212
ceb_Latn-khm_Khmr,191,594,52,191,606,30,1200
aze_Latn-bis_Latn,38,413,37,38,776,30,1189
bod_Tibt-ceb_Latn,96,575,124,96,612,95,1187
ara_Arab-cnh_Latn,52,602,34,52,578,43,1180
cos_Latn-deu_Latn,95,642,17,95,535,18,1177
aze_Latn-kal_Latn,178,596,12,178,521,9,1117
eng_Latn-che_Cyrl,160,564,182,160,538,26,1102
aze_Latn-ber_Latn,81,596,153,81,505,151,1101
nep_Deva-pap_Latn,134,565,9,134,533,13,1098
nep_Deva-sot_Latn,68,490,5,68,606,21,1096
aze_Latn-pap_Latn,146,479,18,146,569,13,1048
arg_Latn-ceb_Latn,106,522,85,106,522,92,1044
aze_Latn-sot_Latn,68,435,24,68,606,22,1041
ceb_Latn-tgk_Cyrl,101,518,65,101,494,60,1012
kal_Latn-nep_Deva,139,424,12,139,586,10,1010
eng_Latn-haw_Latn,112,483,209,112,521,105,1004
aze_Latn-tet_Latn,105,473,77,105,513,65,986
deu_Latn-ksh_Latn,66,515,43,66,470,44,985
eng_Latn-nan_Latn,150,520,177,150,425,22,945
eng_Latn-rue_Cyrl,120,566,240,120,369,74,935
eng_Latn-cos_Latn,69,448,86,69,478,14,926
aze_Latn-zza_Latn,157,493,13,157,429,11,922
deu_Latn-pam_Latn,28,542,39,28,379,123,921
ceb_Latn-gle_Latn,82,464,90,82,457,58,921
eng_Latn-cnh_Latn,35,475,70,35,436,36,911
ara_Arab-lld_Latn,112,431,14,112,477,13,908
ara_Arab-pam_Latn,29,506,20,29,377,123,883
zho_Hani-grc_Grek,161,168,174,161,706,16,874
zho_Hani-pap_Latn,164,231,173,164,638,11,869
eng_Latn-bho_Deva,67,428,121,67,437,1,865
aze_Latn-cnh_Latn,35,379,35,35,431,35,810
deu_Latn-ton_Latn,38,453,34,38,351,123,804
eng_Latn-ksh_Latn,95,419,138,95,383,28,802
aze_Latn-ltz_Latn,119,404,11,119,394,25,798
eng_Latn-npi_Deva,115,392,232,115,397,3,789
lld_Latn-nep_Deva,95,394,12,95,387,3,781
aze_Latn-ewe_Latn,49,390,56,49,388,105,778
ara_Arab-pms_Latn,63,357,10,63,421,12,778
nep_Deva-tet_Latn,83,387,3,83,390,8,777
ara_Arab-che_Cyrl,134,379,3,134,396,3,775
deu_Latn-nan_Latn,133,407,13,133,365,16,772
deu_Latn-gsw_Latn,90,384,58,90,375,63,759
zho_Hani-bis_Latn,31,39,40,31,717,22,756
deu_Latn-zsm_Latn,51,378,42,51,374,39,752
zho_Hani-sot_Latn,99,142,117,99,600,21,742
eng_Latn-bal_Arab,80,345,118,80,393,7,738
aze_Latn-lld_Latn,96,324,14,96,406,13,730
aka_Latn-aze_Latn,76,374,117,76,341,84,715
zho_Hani-tlh_Latn,75,76,78,75,632,81,708
bam_Latn-deu_Latn,62,382,14,62,325,37,707
ara_Arab-run_Latn,139,371,60,139,333,90,704
ceb_Latn-tuk_Latn,56,374,84,56,327,62,701
eng_Latn-hmo_Latn,63,413,141,63,283,36,696
ara_Arab-lfn_Latn,79,277,71,79,409,73,686
ceb_Latn-mos_Latn,50,359,81,50,316,101,675
ceb_Latn-nya_Latn,51,352,80,51,301,94,653
che_Cyrl-deu_Latn,133,342,3,133,302,0,644
aze_Latn-que_Latn,110,356,6,110,280,5,636
deu_Latn-swh_Latn,97,382,62,97,249,62,631
ara_Arab-cos_Latn,55,299,8,55,332,7,631
eng_Latn-nog_Cyrl,84,376,169,84,254,72,630
cos_Latn-nep_Deva,54,328,8,54,299,4,627
eng_Latn-afb_Arab,81,315,161,81,297,44,612
zho_Hani-fao_Latn,143,167,147,143,442,15,609
aze_Latn-cos_Latn,53,276,13,53,318,8,594
aze_Latn-pms_Latn,49,252,9,49,333,10,585
cre_Latn-deu_Latn,23,233,19,23,350,21,583
eng_Latn-pdc_Latn,53,295,108,53,281,26,576
nep_Deva-pms_Latn,44,251,0,44,322,10,573
aze_Latn-che_Cyrl,107,267,4,107,293,3,560
che_Cyrl-nep_Deva,87,245,3,87,314,3,559
ceb_Latn-ltz_Latn,33,305,16,33,246,24,551
avk_Latn-deu_Latn,52,242,43,52,302,44,544
ara_Arab-nan_Latn,96,299,15,96,243,14,542
ace_Latn-aze_Latn,84,296,11,84,246,9,542
ara_Arab-lad_Latn,71,217,68,71,322,69,539
zho_Hani-tet_Latn,97,101,116,97,428,8,529
zho_Hani-pms_Latn,60,117,70,60,409,12,526
deu_Latn-ven_Latn,110,247,6,110,277,10,524
nep_Deva-zza_Latn,84,281,3,84,235,10,516
eng_Latn-ext_Latn,69,279,157,69,235,45,514
deu_Latn-twi_Latn,17,293,0,17,203,19,496
eng_Latn-iba_Latn,31,246,69,31,244,25,490
deu_Latn-nov_Latn,57,248,53,57,241,53,489
ceb_Latn-vec_Latn,51,251,44,51,235,25,486
ceb_Latn-snd_Arab,62,231,40,62,249,30,480
zho_Hani-che_Cyrl,121,139,122,121,323,3,462
zho_Hani-ace_Latn,91,98,101,91,343,12,441
eng_Latn-hil_Latn,43,232,71,43,198,22,430
deu_Latn-nap_Latn,54,209,6,54,208,1,417
eng_Latn-nbl_Latn,36,227,52,36,180,16,407
aze_Latn-nan_Latn,71,203,10,71,194,12,397
zho_Hani-cos_Latn,52,72,61,52,320,7,392
eng_Latn-xmf_Geor,44,214,88,44,175,42,389
aze_Latn-syr_Syrc,70,184,2,70,200,1,384
ceb_Latn-cor_Latn,39,183,55,39,199,56,382
nan_Latn-nep_Deva,71,183,11,71,199,3,382
aze_Latn-fij_Latn,39,180,71,39,199,112,379
eng_Latn-nap_Latn,45,202,56,45,176,1,378
ceb_Latn-lug_Latn,32,167,57,32,207,65,374
eng_Latn-ary_Arab,56,207,107,56,161,8,368
eng_Latn-hif_Latn,36,187,72,36,177,26,364
eng_Latn-ngu_Latn,37,221,74,37,142,15,363
ceb_Latn-roh_Latn,15,175,20,15,185,49,360
zho_Hani-frp_Latn,69,79,75,69,279,7,358
aze_Latn-bam_Latn,26,153,22,26,196,27,349
ceb_Latn-crh_Latn,47,148,6,47,200,9,348
eng_Latn-pnb_Arab,32,162,64,32,180,0,342
ful_Latn-ceb_Latn,28,151,14,28,167,57,318
eng_Latn-sah_Cyrl,39,183,79,39,131,30,314
aka_Latn-ceb_Latn,28,151,89,28,155,52,306
eng_Latn-vls_Latn,12,146,28,12,159,4,305
eng_Latn-mah_Latn,50,165,79,50,136,19,301
ceb_Latn-tet_Latn,31,154,52,31,146,60,300
aze_Latn-kab_Latn,71,152,8,71,148,9,300
deu_Latn-vls_Latn,11,144,39,11,155,4,299
grn_Latn-nep_Deva,61,147,3,61,148,3,295
aze_Latn-mos_Latn,24,142,61,24,151,71,293
bal_Arab-deu_Latn,40,167,0,40,126,2,293
deu_Latn-haw_Latn,18,148,6,18,144,16,292
deu_Latn-hil_Latn,31,125,3,31,166,3,291
deu_Latn-tpi_Latn,30,129,28,30,148,28,277
eng_Latn-tly_Latn,46,167,92,46,109,35,276
aze_Latn-grn_Latn,62,132,5,62,140,3,272
ara_Arab-nap_Latn,37,132,9,37,139,0,271
ara_Arab-bal_Arab,37,120,2,37,150,0,270
zho_Hani-grn_Latn,79,80,81,79,189,4,269
deu_Latn-trv_Latn,28,134,3,28,129,4,263
zho_Hani-aka_Latn,54,86,55,54,175,8,261
ara_Arab-dsb_Latn,48,138,0,48,118,0,256
bal_Arab-nep_Deva,34,133,0,34,120,0,253
aze_Latn-bho_Deva,19,108,8,19,137,1,245
ceb_Latn-ton_Latn,20,120,42,20,116,44,236
aze_Latn-ton_Latn,21,118,44,21,116,44,234
eng_Latn-jam_Latn,35,121,70,35,111,19,232
ara_Arab-bho_Deva,18,97,4,18,132,0,229
zho_Hani-hak_Latn,18,20,28,18,208,16,228
bho_Deva-deu_Latn,17,125,0,17,98,6,223
zho_Hani-dsb_Latn,57,59,67,57,160,9,219
aze_Latn-dsb_Latn,46,110,1,46,109,0,219
ceb_Latn-cym_Latn,26,88,3,26,130,10,218
ceb_Latn-fry_Latn,26,88,4,26,129,11,217
deu_Latn-nbl_Latn,25,115,7,25,97,7,212
dsb_Latn-nep_Deva,44,104,0,44,108,0,212
deu_Latn-lij_Latn,27,121,6,27,89,5,210
eng_Latn-aln_Latn,27,108,56,27,101,16,209
nep_Deva-nbl_Latn,21,124,6,21,85,7,209
deu_Latn-pdc_Latn,24,102,12,24,106,12,208
eng_Latn-pau_Latn,34,97,68,34,106,18,203
eng_Latn-san_Latn,12,107,14,12,95,71,202
aka_Latn-nep_Deva,32,102,1,32,100,1,202
eng_Latn-sgs_Latn,50,120,106,50,78,27,198
eng_Latn-trv_Latn,18,102,19,18,96,3,198
zho_Hani-cdo_Latn,25,32,30,25,163,14,195
ara_Arab-nbl_Latn,21,101,15,21,85,7,186
ara_Arab-ven_Latn,53,90,2,53,88,1,178
deu_Latn-xal_Cyrl,48,89,0,48,83,0,172
deu_Latn-stq_Latn,17,82,13,17,84,13,166
ara_Arab-hil_Latn,19,81,1,19,85,1,166
zho_Hani-cnh_Latn,14,14,27,14,149,8,163
aze_Latn-nap_Latn,29,74,8,29,89,0,163
ara_Arab-trv_Latn,16,83,1,16,74,2,157
eng_Latn-apc_Arab,18,89,37,18,63,12,152
aze_Latn-rom_Latn,30,70,1,30,82,0,152
eng_Latn-myv_Cyrl,26,80,52,26,71,14,151
aze_Latn-hil_Latn,18,68,3,18,83,2,151
zho_Hani-bho_Deva,18,18,22,18,132,0,150
ceb_Latn-nap_Latn,17,77,8,17,70,0,147
zho_Hani-bam_Latn,30,35,30,30,109,1,144
hil_Latn-nep_Deva,17,79,2,17,62,3,141
zho_Hani-ven_Latn,51,51,51,51,86,6,137
ceb_Latn-nds_Latn,22,69,8,22,67,7,136
aze_Latn-ksh_Latn,24,73,7,24,63,4,136
ceb_Latn-sme_Latn,27,71,13,27,64,10,135
ara_Arab-bam_Latn,24,54,1,24,81,1,135
ara_Arab-xal_Cyrl,29,78,0,29,54,0,132
aze_Latn-trv_Latn,15,62,1,15,68,2,130
afb_Arab-deu_Latn,14,54,10,14,74,10,128
eng_Latn-acm_Arab,11,75,22,11,52,10,127
eng_Latn-stq_Latn,11,60,22,11,60,9,120
eng_Latn-koi_Cyrl,14,67,28,14,50,7,117
ceb_Latn-dzo_Tibt,15,53,5,15,63,9,116
eng_Latn-tvl_Latn,15,54,30,15,62,3,116
ara_Arab-vol_Latn,17,52,15,17,63,16,115
ksh_Latn-nep_Deva,24,53,3,24,62,6,115
zho_Hani-war_Latn,12,12,26,12,101,15,113
eng_Latn-nch_Latn,16,70,32,16,43,3,113
eng_Latn-kjh_Cyrl,17,60,34,17,48,12,108
aze_Latn-xal_Cyrl,28,57,0,28,48,0,105
aze_Latn-bak_Latn,15,59,3,15,42,3,101
iku_Cans-nep_Deva,26,38,3,26,61,3,99
deu_Latn-war_Latn,13,50,10,13,44,10,94
nep_Deva-xal_Cyrl,27,50,0,27,44,0,94
aze_Latn-lij_Latn,5,51,1,5,41,1,92
zho_Hani-hil_Latn,16,16,17,16,74,1,90
bam_Latn-nep_Deva,17,53,0,17,35,0,88
nep_Deva-ven_Latn,25,44,1,25,39,0,83
ceb_Latn-srd_Latn,11,35,4,11,47,5,82
ceb_Latn-ckb_Arab,11,45,4,11,37,3,82
aze_Latn-ven_Latn,28,45,1,28,36,0,81
nep_Deva-trv_Latn,10,39,0,10,40,1,79
nap_Latn-nep_Deva,14,44,0,14,34,0,78
ara_Arab-nov_Latn,10,29,9,10,41,9,70
zho_Hani-xal_Cyrl,27,27,27,27,43,0,70
eng_Latn-ady_Cyrl,12,35,24,12,31,10,66
eng_Latn-udm_Cyrl,10,38,20,10,28,5,66
zho_Hani-iku_Cans,26,26,30,26,38,3,64
kom_Cyrl-eng_Latn,15,27,7,15,35,30,62
ceb_Latn-lim_Latn,8,26,1,8,31,4,57
ceb_Latn-shn_Mymr,9,24,1,9,30,4,54
aze_Latn-tlh_Latn,17,32,4,17,21,1,53
nep_Deva-tlh_Latn,16,34,3,16,19,0,53
ceb_Latn-jbo_Latn,6,26,5,6,24,3,50
ceb_Latn-fao_Latn,4,15,2,4,25,5,40
ceb_Latn-frp_Latn,6,21,2,6,18,1,39
ceb_Latn-fur_Latn,6,13,1,6,23,2,36
ceb_Latn-wln_Latn,4,18,2,4,18,2,36
ceb_Latn-kin_Latn,4,21,5,4,14,2,35
ceb_Latn-san_Latn,4,17,3,4,17,2,34
ceb_Latn-swa_Latn,3,18,4,3,15,5,33
ceb_Latn-szl_Latn,6,17,2,6,14,1,31
ceb_Latn-ina_Latn,6,13,1,6,13,1,26
deu_Latn-mah_Latn,10,16,0,10,10,0,26
ceb_Latn-mlt_Latn,3,12,1,3,8,1,20
ceb_Latn-lld_Latn,2,9,2,2,7,1,16
ceb_Latn-sco_Latn,2,6,1,2,9,1,15